MODE 3
MODE2 1
MODE3 4
SIZE 9/9
BEACHBALL 25
MONEYBOX 0
TIMEBOMB 0
DROPING 0/0/0
LIMIT 0/28
COLOR LIMIT 4
COLOR PERCENT 100/0/0/100/100/100
STARS 200/500/600
COLLECT COUNT 16/0/0/0/0/0
COLLECT ITEMS 1/0/0/0/0/0
TOYS COUNT 0/0/0/0
TOYS ITEMS 1/2/3/4
1,0,0 1,0,0 1,0,0 0,0,0 0,0,0 0,0,0 1,0,0 1,0,0 1,0,0
1,0,0 1,0,0 1,0,0 0,0,0 0,0,0 0,0,0 1,0,0 1,0,0 1,0,0
1,0,0 1,0,0 1,8,0 1,8,0 1,8,0 1,8,0 1,8,0 1,0,0 1,0,0
0,0,0 0,0,0 1,8,0 1,8,0 1,8,0 1,8,0 1,8,0 0,0,0 0,0,0
0,0,0 0,0,0 1,8,0 1,8,0 1,8,0 1,8,0 1,8,0 0,0,0 0,0,0
0,0,0 0,0,0 1,8,0 1,8,0 1,8,0 1,8,0 1,8,0 0,0,0 0,0,0
1,0,0 1,0,0 1,8,0 1,8,0 1,8,0 1,8,0 1,8,0 1,0,0 1,0,0
1,0,0 1,0,0 1,0,0 0,0,0 0,0,0 0,0,0 1,0,0 1,0,0 1,0,0
1,0,0 1,0,0 1,0,0 0,0,0 0,0,0 0,0,0 1,0,0 1,0,0 1,0,0