MODE 3
MODE2 1
MODE3 4
DONTINCLUDE 0/0/0
SIZE 9/9
BEACHBALL 25
MONEYBOX 0
TIMEBOMB 0
DROPING 0/0/0
LIMIT 0/35
COLOR LIMIT 4
BUNDLE ABILITY 6
COLOR PERCENT 91/0/97/95/96/0
STARS 1500/11000/20000
COLLECT COUNT 15/0/0/0/0/0
COLLECT ITEMS 3/0/0/0/0/0
TOYS COUNT 0/0/0/0
TOYS ITEMS 1/2/3/4
1,0,0,0,1 1,0,0,0,1 1,0,0,0,1 0,0,0,0,1 0,0,0,0,1 0,0,0,0,1 1,0,0,0,1 1,0,0,0,1 1,0,0,0,1
1,0,0,0,1 1,0,0,0,1 1,0,0,0,1 0,0,0,0,1 1,8,0,0,1 0,0,0,0,1 1,0,0,0,1 1,0,0,0,1 1,0,0,0,1
1,0,0,0,1 1,0,0,0,1 1,0,0,0,1 1,8,0,0,1 1,8,0,0,1 1,8,0,0,1 1,0,0,0,1 1,0,0,0,1 1,0,0,0,1
0,0,0,0,1 0,0,0,0,1 1,8,0,0,1 1,8,0,0,1 1,8,0,0,1 1,8,0,0,1 1,8,0,0,1 0,0,0,0,1 0,0,0,0,1
0,0,0,0,1 1,8,0,0,1 1,8,0,0,1 1,8,0,0,1 1,8,0,0,1 1,8,0,0,1 1,8,0,0,1 1,8,0,0,1 0,0,0,0,1
0,0,0,0,1 0,0,0,0,1 1,8,0,0,1 1,8,0,0,1 1,8,0,0,1 1,8,0,0,1 1,8,0,0,1 0,0,0,0,1 0,0,0,0,1
1,0,0,0,1 1,0,0,0,1 1,0,0,0,1 1,8,0,0,1 1,8,0,0,1 1,8,0,0,1 1,0,0,0,1 1,0,0,0,1 1,0,0,0,1
1,0,0,0,1 1,0,0,0,1 1,0,0,0,1 0,0,0,0,1 1,8,0,0,1 0,0,0,0,1 1,0,0,0,1 1,0,0,0,1 1,0,0,0,1
1,0,0,0,1 1,0,0,0,1 1,0,0,0,1 0,0,0,0,1 0,0,0,0,1 0,0,0,0,1 1,0,0,0,1 1,0,0,0,1 1,0,0,0,1