MODE 3
MODE2 4
MODE3 4
TAG 0
DONTINCLUDE 3/7/0
SIZE 9/9
BEACHBALL 0
MONEYBOX 0
TIMEBOMB 0
DROPING 0/0/0
LIMIT 0/30
COLOR LIMIT 6
BUNDLE ABILITY 5
COLOR PERCENT 100/0/100/100/100/100
STARS 5000/50000/80000
COLLECT COUNT 0/0/0/0/0/0
COLLECT ITEMS 0/0/0/0/0/0
TOYS COUNT 0/0/0/0
TOYS ITEMS 1/2/3/0
2,0,0,0,1 1,0,0,0,1 1,7,0,0,1 0,0,0,0,1 0,0,0,0,1 0,0,0,0,1 1,7,0,0,1 1,0,0,0,1 2,0,0,0,1
2,0,0,0,1 2,0,0,0,1 1,0,0,0,1 1,7,0,0,1 0,0,0,0,1 1,7,0,0,1 1,0,0,0,1 2,0,0,0,1 2,0,0,0,1
2,0,0,0,1 2,0,0,0,1 2,0,0,0,1 1,0,0,0,1 1,7,0,0,1 1,0,0,0,1 2,0,0,0,1 2,0,0,0,1 2,0,0,0,1
0,0,0,0,1 2,0,0,0,1 2,0,0,0,1 2,0,0,0,1 1,12,4,0,3 2,0,0,0,1 2,0,0,0,1 2,0,0,0,1 0,0,0,0,1
0,0,0,0,1 0,0,0,0,1 2,0,0,0,1 2,0,0,0,1 2,7,0,0,1 2,0,0,0,1 2,0,0,0,1 0,0,0,0,1 0,0,0,0,1
0,0,0,0,1 2,0,0,0,1 2,0,0,0,1 2,7,0,0,1 1,12,4,0,3 2,7,0,0,1 2,0,0,0,1 2,0,0,0,1 0,0,0,0,1
2,0,0,0,1 2,0,0,0,1 2,7,0,0,1 1,7,0,0,1 1,7,0,0,1 1,7,0,0,1 2,7,0,0,1 2,0,0,0,1 2,0,0,0,1
2,0,0,0,1 2,7,0,0,1 1,7,0,0,1 1,7,0,0,1 1,0,0,0,1 1,7,0,0,1 1,7,0,0,1 2,7,0,0,1 2,0,0,0,1
2,7,0,0,1 1,7,0,0,1 1,7,0,0,1 1,0,0,0,1 1,0,0,0,1 1,0,0,0,1 1,7,0,0,1 1,7,0,0,1 2,7,0,0,1