MODE 3
MODE2 4
MODE3 4
DONTINCLUDE 3/7/0
SIZE 9/9
BEACHBALL 0
MONEYBOX 0
TIMEBOMB 0
DROPING 0/0/0
LIMIT 0/32
COLOR LIMIT 6
BUNDLE ABILITY 0
COLOR PERCENT 100/0/100/100/100/100
STARS 100/8600/15000
COLLECT COUNT 0/0/0/0/0/0
COLLECT ITEMS 0/0/0/0/0/0
TOYS COUNT 0/0/0/0
TOYS ITEMS 1/2/3/0
2,0,0,0,1 0,0,0,0,1 0,0,0,0,1 0,0,0,0,1 0,0,0,0,1 0,0,0,0,1 0,0,0,0,1 0,0,0,0,1 2,0,0,0,1
2,0,0,0,1 2,0,0,0,1 0,0,0,0,1 0,0,0,0,1 0,0,0,0,1 0,0,0,0,1 0,0,0,0,1 2,0,0,0,1 2,0,0,0,1
2,0,0,0,1 2,0,0,0,1 2,0,0,0,1 0,0,0,0,1 0,0,0,0,1 0,0,0,0,1 2,0,0,0,1 2,0,0,0,1 2,0,0,0,1
2,0,0,0,1 2,0,0,0,1 2,0,0,0,1 2,0,0,0,1 0,0,0,0,1 2,0,0,0,1 2,0,0,0,1 2,0,0,0,1 2,0,0,0,1
2,0,0,0,1 2,0,0,0,1 2,0,0,0,1 2,0,0,0,1 2,7,0,0,1 2,0,0,0,1 2,0,0,0,1 2,0,0,0,1 2,0,0,0,1
2,0,0,0,1 2,0,0,0,1 2,0,0,0,1 2,7,0,0,1 2,7,0,0,1 2,7,0,0,1 2,0,0,0,1 2,0,0,0,1 2,0,0,0,1
2,0,0,0,1 2,0,0,0,1 2,7,0,0,1 2,7,0,0,1 2,7,0,0,1 2,7,0,0,1 2,7,0,0,1 2,0,0,0,1 2,0,0,0,1
2,0,0,0,1 2,7,0,0,1 2,7,0,0,1 2,7,0,0,1 1,12,4,0,3 2,7,0,0,1 2,7,0,0,1 2,7,0,0,1 2,0,0,0,1
2,7,0,0,1 2,7,0,0,1 2,7,0,0,1 2,7,0,0,1 1,12,4,0,3 2,7,0,0,1 2,7,0,0,1 2,7,0,0,1 2,7,0,0,1