MODE 1
MODE2 4
MODE3 4
DONTINCLUDE 0/0/0
SIZE 9/9
BEACHBALL 0
MONEYBOX 0
TIMEBOMB 0
DROPING 0/0/0
LIMIT 0/180
COLOR LIMIT 6
BUNDLE ABILITY 52
COLOR PERCENT 100/100/100/100/100/100
STARS 200/400/600
COLLECT COUNT 50/10/99/20/0/0
COLLECT ITEMS 1/2/3/4/0/0
TOYS COUNT 0/0/0/0
TOYS ITEMS 1/2/3/4
1,0,0,0,1 1,0,0,0,1 1,0,0,0,1 1,0,0,0,1 1,0,0,0,1 1,0,0,0,1 1,0,0,0,1 1,0,0,0,1 1,0,0,0,1
1,0,0,0,1 1,0,0,0,1 1,0,0,0,1 1,0,0,0,1 1,0,0,0,1 1,0,0,0,1 1,0,0,0,1 1,0,0,0,1 1,0,0,0,1
1,0,0,0,1 2,0,0,0,1 2,0,0,0,1 2,0,0,0,1 2,0,0,0,1 2,0,0,0,1 2,0,0,0,1 2,0,0,0,1 1,0,0,0,1
1,0,0,0,1 2,0,0,0,1 2,0,0,0,1 2,0,0,0,1 2,0,0,0,1 2,0,0,0,1 2,0,0,0,1 2,0,0,0,1 1,0,0,0,1
1,0,0,0,1 2,0,0,0,1 2,0,0,0,1 2,0,0,0,1 2,0,0,0,1 2,0,0,0,1 2,0,0,0,1 2,0,0,0,1 1,0,0,0,1
1,0,0,0,1 2,0,0,0,1 2,0,0,0,1 2,0,0,0,1 2,0,0,0,1 2,0,0,0,1 2,0,0,0,1 2,0,0,0,1 1,0,0,0,1
1,0,0,0,1 1,0,0,0,1 1,0,0,0,1 1,0,0,0,1 1,0,0,0,1 1,0,0,0,1 1,0,0,0,1 1,0,0,0,1 1,0,0,0,1
1,0,0,0,1 1,0,0,0,1 1,0,0,0,1 1,0,0,0,1 1,0,0,0,1 1,0,0,0,1 1,0,0,0,1 1,0,0,0,1 1,0,0,0,1
1,0,0,0,1 1,0,0,0,1 1,0,0,0,1 1,0,0,0,1 1,0,0,0,1 1,0,0,0,1 1,0,0,0,1 1,0,0,0,1 1,0,0,0,1