MODE 3
MODE2 1
MODE3 4
DONTINCLUDE 0/0/0
SIZE 9/9
BEACHBALL 36
MONEYBOX 0
TIMEBOMB 0
DROPING 0/0/0
LIMIT 0/35
COLOR LIMIT 6
BUNDLE ABILITY 3
COLOR PERCENT 94/0/95/0/86/91
STARS 3000/11000/20000
COLLECT COUNT 25/35/25/0/0/0
COLLECT ITEMS 3/1/6/0/0/0
TOYS COUNT 0/0/0/0
TOYS ITEMS 0/0/0/0
1,0,0,0,1 1,0,0,0,1 1,8,0,0,1 1,8,0,0,1 1,0,0,0,1 1,8,0,0,1 1,8,0,0,1 1,0,0,0,1 1,0,0,0,1
1,0,0,0,1 1,0,0,0,1 1,8,0,0,1 1,8,0,0,1 1,0,0,0,1 1,8,0,0,1 1,8,0,0,1 1,0,0,0,1 1,0,0,0,1
0,0,0,0,1 1,0,0,0,1 1,8,0,0,1 1,8,0,0,1 1,0,0,0,1 1,8,0,0,1 1,8,0,0,1 1,0,0,0,1 0,0,0,0,1
1,0,0,0,1 1,0,0,0,1 1,8,0,0,1 1,8,0,0,1 1,0,0,0,1 1,8,0,0,1 1,8,0,0,1 1,0,0,0,1 1,0,0,0,1
1,0,0,0,1 1,0,0,0,1 1,8,0,0,1 1,8,0,0,1 0,0,0,0,1 1,8,0,0,1 1,8,0,0,1 1,0,0,0,1 1,0,0,0,1
1,0,0,0,1 1,0,0,0,1 1,8,0,0,1 1,8,0,0,1 1,0,0,0,1 1,8,0,0,1 1,8,0,0,1 1,0,0,0,1 1,0,0,0,1
0,0,0,0,1 1,0,0,0,1 1,8,0,0,1 1,8,0,0,1 1,0,0,0,1 1,8,0,0,1 1,8,0,0,1 1,0,0,0,1 0,0,0,0,1
1,0,0,0,1 1,0,0,0,1 1,8,0,0,1 1,8,0,0,1 1,0,0,0,1 1,8,0,0,1 1,8,0,0,1 1,0,0,0,1 1,0,0,0,1
1,0,0,0,1 1,0,0,0,1 1,8,0,0,1 1,8,0,0,1 1,0,0,0,1 1,8,0,0,1 1,8,0,0,1 1,0,0,0,1 1,0,0,0,1