MODE 2
MODE2 4
MODE3 4
SIZE 9/6
BEACHBALL 0
MONEYBOX 0
TIMEBOMB 0
DROPING 0/0/0
LIMIT 0/16
COLOR LIMIT 4
BUNDLE ABILITY 0
COLOR PERCENT 100/100/100/100/100/100
STARS 800/1300/1950
COLLECT COUNT 0/4/0/0/0/0
COLLECT ITEMS 1/2/3/4/0/0
TOYS COUNT 0/0/0/0
TOYS ITEMS 1/0/0/0
0,0,0 0,0,0 1,0,0 1,0,0 1,0,0 1,0,0 1,0,0 0,0,0 0,0,0
0,0,0 1,0,0 1,0,0 1,0,0 0,0,0 1,0,0 1,0,0 1,0,0 0,0,0
1,0,0 0,0,0 1,0,0 1,0,0 1,0,0 1,0,0 1,0,0 1,0,0 1,0,0
1,0,0 1,0,0 1,0,0 0,0,0 0,0,0 0,0,0 1,0,0 1,0,0 1,0,0
1,0,0 1,0,0 1,0,0 1,0,0 0,0,0 1,0,0 1,0,0 1,0,0 0,0,0
1,0,0 1,0,0 1,0,0 1,0,0 0,0,0 1,0,0 1,0,0 1,0,0 1,0,0