MODE 3
MODE2 4
MODE3 4
DONTINCLUDE 0/0/0
SIZE 7/8
BEACHBALL 0
MONEYBOX 0
TIMEBOMB 0
DROPING 0/0/0
LIMIT 0/25
COLOR LIMIT 6
BUNDLE ABILITY 5
COLOR PERCENT 100/100/97/96/97/95
STARS 7000/40000/80000
COLLECT COUNT 0/0/30/0/0/0
COLLECT ITEMS 1/2/5/0/0/0
TOYS COUNT 0/0/0/0
TOYS ITEMS 1/0/0/0
0,0,0,0,1 1,0,0,0,1 1,0,0,0,1 1,0,0,0,1 1,0,0,0,1 1,0,0,0,1 0,0,0,0,1
1,0,0,0,1 1,0,0,0,1 1,0,0,0,1 1,0,0,0,1 1,0,0,0,1 1,0,0,0,1 1,0,0,0,1
1,0,0,0,1 2,0,0,0,1 2,0,0,0,1 2,0,0,0,1 2,0,0,0,1 2,0,0,0,1 1,0,0,0,1
1,0,0,0,1 2,0,0,0,1 2,0,0,0,1 2,11,5,0,1 2,0,0,0,1 2,0,0,0,1 1,0,0,0,1
1,0,0,0,1 2,0,0,0,1 2,0,0,0,1 2,11,5,0,1 2,0,0,0,1 2,0,0,0,1 1,0,0,0,1
1,0,0,0,1 2,0,0,0,1 2,0,0,0,1 2,0,0,0,1 2,0,0,0,1 2,0,0,0,1 1,0,0,0,1
1,0,0,0,1 1,0,0,0,1 1,0,0,0,1 1,0,0,0,1 1,0,0,0,1 1,0,0,0,1 1,0,0,0,1
0,0,0,0,1 1,0,0,0,1 1,0,0,0,1 1,0,0,0,1 1,0,0,0,1 1,0,0,0,1 0,0,0,0,1