MODE 2
MODE2 4
MODE3 4
DONTINCLUDE 0/0/0
SIZE 9/9
BEACHBALL 0
MONEYBOX 0
TIMEBOMB 0
DROPING 0/0/0
LIMIT 0/50
COLOR LIMIT 6
BUNDLE ABILITY 6
COLOR PERCENT 64/0/63/0/63/64
STARS 5000/45000/80000
COLLECT COUNT 25/35/30/0/0/0
COLLECT ITEMS 2/5/5/0/0/0
TOYS COUNT 2/2/2/0
TOYS ITEMS 1/2/3/0
1,0,0,0,1 1,0,0,0,1 1,0,0,0,1 1,0,0,0,1 1,0,0,0,1 1,0,0,0,1 1,0,0,0,1 1,0,0,0,1 1,0,0,0,1
1,0,0,0,1 1,8,0,0,1 1,8,0,0,1 1,8,0,0,1 1,8,0,0,1 1,8,0,0,1 1,8,0,0,1 1,8,0,0,1 1,0,0,0,1
1,0,0,0,1 1,8,0,0,1 1,8,0,0,1 1,0,0,0,1 1,0,0,0,1 1,0,0,0,1 1,8,0,0,1 1,8,0,0,1 1,0,0,0,1
1,0,0,0,1 1,8,0,0,1 1,0,0,0,1 1,8,0,0,1 1,0,0,0,1 1,8,0,0,1 1,0,0,0,1 1,8,0,0,1 1,0,0,0,1
1,0,0,0,1 1,8,0,0,1 0,0,0,0,1 1,0,0,0,1 1,10,1,0,1 1,0,0,0,1 0,0,0,0,1 1,8,0,0,1 1,0,0,0,1
1,0,0,0,1 1,8,0,0,1 1,0,0,0,1 1,8,0,0,1 1,0,0,0,1 1,8,0,0,1 1,0,0,0,1 1,8,0,0,1 1,0,0,0,1
1,0,0,0,1 1,8,0,0,1 1,8,0,0,1 1,0,0,0,1 1,0,0,0,1 1,0,0,0,1 1,8,0,0,1 1,8,0,0,1 1,0,0,0,1
1,0,0,0,1 1,8,0,0,1 1,8,0,0,1 1,8,0,0,1 1,8,0,0,1 1,8,0,0,1 1,8,0,0,1 1,8,0,0,1 1,0,0,0,1
1,0,0,0,1 1,0,0,0,1 1,0,0,0,1 1,0,0,0,1 1,0,0,0,1 1,0,0,0,1 1,0,0,0,1 1,0,0,0,1 1,0,0,0,1