MODE 2
MODE2 4
MODE3 4
SIZE 9/9
BEACHBALL 0
MONEYBOX 0
TIMEBOMB 0
DROPING 0/0/0
LIMIT 0/45
COLOR LIMIT 6
BUNDLE ABILITY 0
COLOR PERCENT 100/0/0/100/100/100
STARS 100/2500/3800
COLLECT COUNT 25/35/30/0/0/0
COLLECT ITEMS 2/5/5/0/0/0
TOYS COUNT 2/2/2/0
TOYS ITEMS 1/2/3/0
1,8,0 1,8,0 1,8,0 1,8,0 1,8,0 1,8,0 1,8,0 1,8,0 1,8,0
1,8,0 1,0,0 1,0,0 1,0,0 1,0,0 1,0,0 1,0,0 1,0,0 1,8,0
1,8,0 1,0,0 1,0,0 1,0,0 1,0,0 1,0,0 1,0,0 1,0,0 1,8,0
1,8,0 1,0,0 1,0,0 1,8,0 1,8,0 1,8,0 1,0,0 1,0,0 1,8,0
1,8,0 1,0,0 0,0,0 1,8,0 1,10,1 1,8,0 0,0,0 1,0,0 1,8,0
1,8,0 1,0,0 1,0,0 1,8,0 1,8,0 1,8,0 1,0,0 1,0,0 1,8,0
1,8,0 1,0,0 1,0,0 1,0,0 1,0,0 1,0,0 1,0,0 1,0,0 1,8,0
1,8,0 1,0,0 1,0,0 1,0,0 1,0,0 1,0,0 1,0,0 1,0,0 1,8,0
1,8,0 1,8,0 1,8,0 1,8,0 1,8,0 1,8,0 1,8,0 1,8,0 1,8,0