MODE 3
MODE2 4
MODE3 4
DONTINCLUDE 0/0/0
SIZE 7/9
BEACHBALL 0
MONEYBOX 0
TIMEBOMB 0
DROPING 0/0/0
LIMIT 0/35
COLOR LIMIT 6
BUNDLE ABILITY 0
COLOR PERCENT 0/100/100/100/100/100
STARS 100/5600/6700
COLLECT COUNT 20/20/30/0/0/0
COLLECT ITEMS 1/4/5/0/0/0
TOYS COUNT 0/0/0/0
TOYS ITEMS 1/2/3/0
1,0,0 1,0,0 1,0,0 1,0,0 1,0,0 1,0,0 1,0,0
1,0,0 1,0,0 1,0,0 1,0,0 1,0,0 1,0,0 1,0,0
1,4,0 1,4,0 1,4,0 1,4,0 1,4,0 1,4,0 1,4,0
1,0,0 1,0,0 1,0,0 1,0,0 1,0,0 1,0,0 1,0,0
1,4,0 1,4,0 1,4,0 1,4,0 1,4,0 1,4,0 1,4,0
1,4,0 1,4,0 1,4,0 1,4,0 1,4,0 1,4,0 1,4,0
1,0,0 1,0,0 1,0,0 1,0,0 1,0,0 1,0,0 1,0,0
1,4,0 1,4,0 1,4,0 1,4,0 1,4,0 1,4,0 1,4,0
1,4,0 1,4,0 1,4,0 1,4,0 1,4,0 1,4,0 1,4,0