MODE 3
MODE2 4
MODE3 4
DONTINCLUDE 4/0/0
SIZE 9/9
BEACHBALL 0
MONEYBOX 0
TIMEBOMB 0
DROPING 0/0/0
LIMIT 0/40
COLOR LIMIT 6
BUNDLE ABILITY 4
COLOR PERCENT 76/86/74/0/73/0
STARS 5000/30000/65000
COLLECT COUNT 2/2/25/0/0/0
COLLECT ITEMS 1/2/6/0/0/0
TOYS COUNT 0/0/0/0
TOYS ITEMS 1/2/3/0
1,0,0,0,1 1,0,0,0,1 1,0,0,0,1 1,0,0,0,1 0,0,0,0,1 1,0,0,0,1 1,0,0,0,1 1,0,0,0,1 1,0,0,0,1
1,0,0,0,1 1,0,0,0,1 1,0,0,0,1 1,0,0,0,1 0,0,0,0,1 1,0,0,0,1 1,0,0,0,1 1,0,0,0,1 1,0,0,0,1
2,0,0,0,1 2,0,0,0,1 2,0,0,0,1 2,0,0,0,1 0,0,0,0,1 2,0,0,0,1 2,0,0,0,1 2,0,0,0,1 2,0,0,0,1
2,4,0,0,1 2,4,0,0,1 2,4,0,0,1 2,4,0,0,1 0,0,0,0,1 2,4,0,0,1 2,4,0,0,1 2,4,0,0,1 2,4,0,0,1
0,0,0,0,1 0,0,0,0,1 0,0,0,0,1 0,0,0,0,1 0,0,0,0,1 0,0,0,0,1 0,0,0,0,1 0,0,0,0,1 0,0,0,0,1
1,0,0,0,1 1,0,0,0,1 1,0,0,0,1 1,0,0,0,1 0,0,0,0,1 1,0,0,0,1 1,0,0,0,1 1,0,0,0,1 1,0,0,0,1
1,0,0,0,1 1,0,0,0,1 1,0,0,0,1 1,0,0,0,1 0,0,0,0,1 1,0,0,0,1 1,0,0,0,1 1,0,0,0,1 1,0,0,0,1
2,0,0,0,1 2,0,0,0,1 2,0,0,0,1 2,0,0,0,1 0,0,0,0,1 2,0,0,0,1 2,0,0,0,1 2,0,0,0,1 2,0,0,0,1
2,4,0,0,1 2,4,0,0,1 2,4,0,0,1 2,4,0,0,1 0,0,0,0,1 2,4,0,0,1 2,4,0,0,1 2,4,0,0,1 2,4,0,0,1