MODE 4
MODE2 3
MODE3 4
DONTINCLUDE 4/0/0
SIZE 7/9
BEACHBALL 0
MONEYBOX 0
TIMEBOMB 0
DROPING 0/0/0
LIMIT 0/35
COLOR LIMIT 6
BUNDLE ABILITY 7
COLOR PERCENT 0/64/0/68/67/69
STARS 5000/30000/55000
COLLECT COUNT 45/55/25/0/0/0
COLLECT ITEMS 4/5/3/0/0/0
TOYS COUNT 0/0/0/0
TOYS ITEMS 1/2/3/0
0,0,0,0,1 0,0,0,0,1 2,0,0,0,1 2,0,0,0,1 2,0,0,0,1 2,0,0,0,1 2,0,0,0,1
1,0,0,0,1 1,0,0,0,1 1,0,0,0,1 1,0,0,0,1 2,4,0,0,1 2,4,0,0,1 2,0,0,0,1
1,0,0,0,1 1,0,0,0,1 1,0,0,0,1 1,0,0,0,1 2,4,0,0,1 2,4,0,0,1 2,0,0,0,1
2,0,0,0,1 1,0,0,0,1 1,0,0,0,1 1,0,0,0,1 1,0,0,0,1 1,0,0,0,1 2,0,0,0,1
2,0,0,0,1 1,0,0,0,1 0,0,0,0,1 1,0,0,0,1 0,0,0,0,1 1,0,0,0,1 2,0,0,0,1
2,0,0,0,1 1,0,0,0,1 1,0,0,0,1 1,0,0,0,1 1,0,0,0,1 1,0,0,0,1 2,0,0,0,1
2,0,0,0,1 2,4,0,0,1 2,4,0,0,1 1,0,0,0,1 1,0,0,0,1 1,0,0,0,1 1,0,0,0,1
2,0,0,0,1 2,4,0,0,1 2,4,0,0,1 1,0,0,0,1 1,0,0,0,1 1,0,0,0,1 1,0,0,0,1
2,0,0,0,1 2,0,0,0,1 2,0,0,0,1 2,0,0,0,1 2,0,0,0,1 0,0,0,0,1 0,0,0,0,1