MODE 1
MODE2 4
MODE3 4
SIZE 7/7
BEACHBALL 0
MONEYBOX 0
TIMEBOMB 0
DROPING 0/0/0
LIMIT 0/20
COLOR LIMIT 5
COLOR PERCENT 25/0/25/100/100/25
STARS 500/1000/1300
COLLECT COUNT 4/20/0/0/0/0
COLLECT ITEMS 4/5/0/0/0/0
TOYS COUNT 0/0/0/0
TOYS ITEMS 1/3/0/0
0,0,0 1,0,0 1,0,0 1,0,0 1,0,0 1,0,0 0,0,0
1,0,0 1,0,0 1,0,0 1,0,0 1,0,0 1,0,0 1,0,0
1,0,0 1,0,0 1,0,0 1,0,0 1,0,0 1,0,0 1,0,0
1,0,0 1,0,0 1,0,0 1,0,0 1,0,0 1,0,0 1,0,0
1,0,0 1,0,0 1,0,0 1,0,0 1,0,0 1,0,0 1,0,0
1,0,0 1,0,0 1,0,0 1,0,0 1,0,0 1,0,0 1,0,0
0,0,0 1,0,0 1,0,0 1,0,0 1,0,0 1,0,0 0,0,0