MODE 2
MODE2 4
MODE3 4
DONTINCLUDE 0/0/0
SIZE 9/9
BEACHBALL 0
MONEYBOX 0
TIMEBOMB 0
DROPING 0/0/0
LIMIT 0/42
COLOR LIMIT 6
BUNDLE ABILITY 8
COLOR PERCENT 0/79/77/0/78/73
STARS 7000/35000/63000
COLLECT COUNT 25/30/25/0/0/0
COLLECT ITEMS 4/5/3/0/0/0
TOYS COUNT 3/3/0/0
TOYS ITEMS 1/2/0/0
0,0,0,0,1 1,10,1,0,1 1,0,0,0,1 1,0,0,0,1 0,0,0,0,1 1,0,0,0,1 1,0,0,0,1 1,10,2,0,1 0,0,0,0,1
1,0,0,0,1 1,0,0,0,1 1,0,0,0,1 1,0,0,0,1 0,0,0,0,1 1,0,0,0,1 1,0,0,0,1 1,0,0,0,1 1,0,0,0,1
1,0,0,0,1 1,0,0,0,1 1,0,0,0,1 1,0,0,0,1 1,0,0,0,1 1,0,0,0,1 1,0,0,0,1 1,0,0,0,1 1,0,0,0,1
0,0,0,0,1 1,4,0,0,1 1,4,0,0,1 1,4,0,0,1 1,4,0,0,1 1,4,0,0,1 1,4,0,0,1 1,4,0,0,1 0,0,0,0,1
0,0,0,0,1 1,4,0,0,1 1,4,0,0,1 1,4,0,0,1 0,0,0,0,1 1,4,0,0,1 1,4,0,0,1 1,4,0,0,1 0,0,0,0,1
0,0,0,0,1 1,4,0,0,1 1,4,0,0,1 1,4,0,0,1 1,4,0,0,1 1,4,0,0,1 1,4,0,0,1 1,4,0,0,1 0,0,0,0,1
1,0,0,0,1 1,0,0,0,1 1,0,0,0,1 1,0,0,0,1 1,0,0,0,1 1,0,0,0,1 1,0,0,0,1 1,0,0,0,1 1,0,0,0,1
1,0,0,0,1 1,0,0,0,1 1,0,0,0,1 1,0,0,0,1 1,0,0,0,1 1,0,0,0,1 1,0,0,0,1 1,0,0,0,1 1,0,0,0,1
0,0,0,0,1 1,0,0,0,1 1,0,0,0,1 1,0,0,0,1 1,0,0,0,1 1,0,0,0,1 1,0,0,0,1 1,0,0,0,1 0,0,0,0,1