MODE 3
MODE2 4
MODE3 4
DONTINCLUDE 0/0/0
SIZE 6/9
BEACHBALL 0
MONEYBOX 0
TIMEBOMB 0
DROPING 0/0/0
LIMIT 0/40
COLOR LIMIT 6
BUNDLE ABILITY 5
COLOR PERCENT 60/57/51/60/0/58
STARS 5000/35000/70000
COLLECT COUNT 0/0/25/0/0/0
COLLECT ITEMS 1/2/3/0/0/0
TOYS COUNT 0/0/0/0
TOYS ITEMS 1/2/0/0
1,11,5,0,1 1,0,0,0,1 1,0,0,0,1 1,0,0,0,1 1,0,0,0,1 1,0,0,0,1
1,11,5,0,1 1,0,0,0,1 1,0,0,0,1 1,0,0,0,1 1,0,0,0,1 1,0,0,0,1
1,3,0,0,1 1,3,0,0,1 1,3,0,0,1 1,3,0,0,1 1,3,0,0,1 1,3,0,0,1
0,0,0,0,1 0,0,0,0,1 1,3,0,0,1 1,3,0,0,1 0,0,0,0,1 0,0,0,0,1
0,0,0,0,1 0,0,0,0,1 0,0,0,0,1 0,0,0,0,1 0,0,0,0,1 0,0,0,0,1
0,0,0,0,1 0,0,0,0,1 1,0,0,0,1 1,0,0,0,1 0,0,0,0,1 0,0,0,0,1
1,0,0,0,1 1,0,0,0,1 1,0,0,0,1 1,0,0,0,1 1,0,0,0,1 1,0,0,0,1
1,3,0,0,1 1,3,0,0,1 1,3,0,0,1 1,3,0,0,1 1,3,0,0,1 1,3,0,0,1
1,0,0,0,1 1,0,0,0,1 1,0,0,0,1 1,0,0,0,1 1,0,0,0,1 1,0,0,0,1