MODE 3
MODE2 4
MODE3 4
TAG 1
DONTINCLUDE 0/0/0
SIZE 6/9
BEACHBALL 0
MONEYBOX 0
TIMEBOMB 0
DROPING 0/0/0
LIMIT 0/50
COLOR LIMIT 6
BUNDLE ABILITY 0
COLOR PERCENT 57/57/58/58/0/58
STARS 5000/35000/70000
COLLECT COUNT 0/0/25/0/0/0
COLLECT ITEMS 1/2/3/0/0/0
TOYS COUNT 0/0/0/0
TOYS ITEMS 1/2/0/0
1,0,0,0,1 1,0,0,0,1 1,0,0,0,1 1,0,0,0,1 1,0,0,0,1 1,0,0,0,1
1,0,0,0,1 1,0,0,0,1 1,0,0,0,1 1,0,0,0,1 1,0,0,0,1 1,0,0,0,1
1,3,0,0,1 1,3,0,0,1 1,3,0,0,1 1,3,0,0,1 1,3,0,0,1 1,3,0,0,1
1,11,0,0,1 1,11,0,0,1 1,3,0,0,1 1,3,0,0,1 1,11,0,0,1 1,11,0,0,1
1,11,0,0,1 1,11,0,0,1 1,11,0,0,1 1,11,0,0,1 1,11,0,0,1 1,11,0,0,1
1,11,0,0,1 1,11,0,0,1 1,0,0,0,1 1,0,0,0,1 1,11,0,0,1 1,11,0,0,1
1,11,0,0,1 1,11,0,0,1 1,0,0,0,1 1,0,0,0,1 1,11,0,0,1 1,11,0,0,1
1,3,0,0,1 1,3,0,0,1 1,3,0,0,1 1,3,0,0,1 1,3,0,0,1 1,3,0,0,1
1,0,0,0,1 1,0,0,0,1 1,0,0,0,1 1,0,0,0,1 1,0,0,0,1 1,0,0,0,1