MODE 1
MODE2 3
MODE3 4
DONTINCLUDE 4/0/0
SIZE 8/9
BEACHBALL 0
MONEYBOX 0
TIMEBOMB 0
DROPING 0/0/0
LIMIT 0/50
COLOR LIMIT 6
BUNDLE ABILITY 5
COLOR PERCENT 48/0/56/55/54/59
STARS 7000/35000/75000
COLLECT COUNT 20/0/0/0/0/0
COLLECT ITEMS 1/0/0/0/0/0
TOYS COUNT 0/0/0/0
TOYS ITEMS 1/2/0/0
0,0,0,0,1 0,0,0,0,1 1,0,0,0,1 1,0,0,0,1 1,0,0,0,1 1,0,0,0,1 0,0,0,0,1 0,0,0,0,1
0,0,0,0,1 1,0,0,0,1 1,0,0,0,1 1,0,0,0,1 1,0,0,0,1 1,0,0,0,1 1,0,0,0,1 0,0,0,0,1
1,0,0,0,1 1,0,0,0,1 1,0,0,0,1 1,0,0,0,1 1,0,0,0,1 1,0,0,0,1 1,0,0,0,1 1,0,0,0,1
1,4,0,0,1 1,4,0,0,1 1,4,0,0,1 1,4,0,0,1 1,4,0,0,1 1,4,0,0,1 1,4,0,0,1 1,4,0,0,1
1,3,0,0,1 1,3,0,0,1 1,3,0,0,1 1,3,0,0,1 1,3,0,0,1 1,3,0,0,1 1,3,0,0,1 1,3,0,0,1
1,0,0,0,1 1,0,0,0,1 1,0,0,0,1 1,0,0,0,1 1,0,0,0,1 1,0,0,0,1 1,0,0,0,1 1,0,0,0,1
1,0,0,0,1 1,0,0,0,1 1,0,0,0,1 1,0,0,0,1 1,0,0,0,1 1,0,0,0,1 1,0,0,0,1 1,0,0,0,1
0,0,0,0,1 1,0,0,0,1 1,0,0,0,1 1,0,0,0,1 1,0,0,0,1 1,0,0,0,1 1,0,0,0,1 0,0,0,0,1
0,0,0,0,1 0,0,0,0,1 1,0,0,0,1 1,0,0,0,1 1,0,0,0,1 1,0,0,0,1 0,0,0,0,1 0,0,0,0,1