MODE 3
MODE2 1
MODE3 4
DONTINCLUDE 0/0/0
SIZE 9/9
BEACHBALL 0
MONEYBOX 0
TIMEBOMB 0
DROPING 0/0/0
LIMIT 0/50
COLOR LIMIT 6
BUNDLE ABILITY 9
COLOR PERCENT 0/57/52/49/55/51
STARS 7000/36000/75000
COLLECT COUNT 25/25/0/0/0/0
COLLECT ITEMS 2/5/0/0/0/0
TOYS COUNT 0/0/0/0
TOYS ITEMS 1/2/0/0
0,0,0,0,1 1,0,0,0,1 1,0,0,0,1 1,0,0,0,1 0,0,0,0,1 1,0,0,0,1 1,0,0,0,1 1,0,0,0,1 0,0,0,0,1
1,0,0,0,1 1,0,0,0,1 1,0,0,0,1 1,0,0,0,1 0,0,0,0,1 1,0,0,0,1 1,0,0,0,1 1,0,0,0,1 1,0,0,0,1
1,0,0,0,1 1,0,0,0,1 1,0,0,0,1 1,0,0,0,1 0,0,0,0,1 1,0,0,0,1 1,0,0,0,1 1,0,0,0,1 1,0,0,0,1
1,0,0,0,1 1,0,0,0,1 1,0,0,0,1 1,3,0,0,1 1,3,0,0,1 1,3,0,0,1 1,0,0,0,1 1,0,0,0,1 1,0,0,0,1
0,0,0,0,1 0,0,0,0,1 0,0,0,0,1 1,3,0,0,1 1,3,0,0,1 1,3,0,0,1 0,0,0,0,1 0,0,0,0,1 0,0,0,0,1
1,0,0,0,1 1,0,0,0,1 1,0,0,0,1 1,3,0,0,1 1,3,0,0,1 1,3,0,0,1 1,0,0,0,1 1,0,0,0,1 1,0,0,0,1
1,0,0,0,1 1,0,0,0,1 1,0,0,0,1 1,0,0,0,1 0,0,0,0,1 1,0,0,0,1 1,0,0,0,1 1,0,0,0,1 1,0,0,0,1
1,0,0,0,1 1,0,0,0,1 1,0,0,0,1 1,0,0,0,1 0,0,0,0,1 1,0,0,0,1 1,0,0,0,1 1,0,0,0,1 1,0,0,0,1
0,0,0,0,1 1,0,0,0,1 1,0,0,0,1 1,0,0,0,1 0,0,0,0,1 1,0,0,0,1 1,0,0,0,1 1,0,0,0,1 0,0,0,0,1