MODE 3
MODE2 4
MODE3 4
DONTINCLUDE 3/0/0
SIZE 7/9
BEACHBALL 0
MONEYBOX 0
TIMEBOMB 0
DROPING 0/0/0
LIMIT 0/33
COLOR LIMIT 6
BUNDLE ABILITY 1
COLOR PERCENT 90/86/90/0/89/0
STARS 5500/30000/50000
COLLECT COUNT 0/0/0/0/0/0
COLLECT ITEMS 1/2/0/0/0/0
TOYS COUNT 0/0/0/0
TOYS ITEMS 1/2/0/0
1,0,0,0,1 1,0,0,0,1 1,0,0,0,1 1,0,0,0,1 1,0,0,0,1 1,0,0,0,1 1,0,0,0,1
1,0,0,0,1 1,0,0,0,1 1,0,0,0,1 1,0,0,0,1 1,0,0,0,1 1,0,0,0,1 1,0,0,0,1
1,3,0,0,1 1,0,0,0,1 1,3,0,0,1 1,0,0,0,1 1,3,0,0,1 1,0,0,0,1 1,3,0,0,1
1,0,0,0,1 1,0,0,0,1 1,0,0,0,1 1,0,0,0,1 1,0,0,0,1 1,0,0,0,1 1,0,0,0,1
1,0,0,0,1 1,0,0,0,1 1,0,0,0,1 1,0,0,0,1 1,0,0,0,1 1,0,0,0,1 1,0,0,0,1
1,0,0,0,1 1,0,0,0,1 1,0,0,0,1 1,0,0,0,1 1,0,0,0,1 1,0,0,0,1 1,0,0,0,1
2,8,0,0,1 2,8,0,0,1 2,8,0,0,1 2,8,0,0,1 2,8,0,0,1 2,8,0,0,1 2,8,0,0,1
1,0,0,0,1 1,0,0,0,1 2,8,0,0,1 2,8,0,0,1 2,8,0,0,1 1,0,0,0,1 1,0,0,0,1
2,8,0,0,1 2,8,0,0,1 2,8,0,0,1 2,8,0,0,1 2,8,0,0,1 2,8,0,0,1 2,8,0,0,1