MODE 2
MODE2 4
MODE3 4
DONTINCLUDE 0/0/0
SIZE 9/9
BEACHBALL 0
MONEYBOX 0
TIMEBOMB 0
DROPING 0/0/0
LIMIT 0/42
COLOR LIMIT 6
BUNDLE ABILITY 3
COLOR PERCENT 95/0/97/0/94/92
STARS 5000/30000/60000
COLLECT COUNT 0/0/0/0/0/0
COLLECT ITEMS 1/2/0/0/0/0
TOYS COUNT 1/1/1/1
TOYS ITEMS 1/2/3/4
1,0,0,0,1 0,0,0,0,1 0,0,0,0,1 1,0,0,0,1 1,0,0,0,1 1,0,0,0,1 0,0,0,0,1 0,0,0,0,1 1,0,0,0,1
1,0,0,0,1 1,0,0,0,1 1,0,0,0,1 1,0,0,0,1 1,0,0,0,1 1,0,0,0,1 1,0,0,0,1 1,0,0,0,1 1,0,0,0,1
1,10,1,0,1 1,0,0,0,1 1,0,0,0,1 1,10,2,0,1 1,0,0,0,1 1,10,3,0,1 1,0,0,0,1 1,0,0,0,1 1,10,4,0,1
1,0,0,0,1 1,0,0,0,1 1,0,0,0,1 1,0,0,0,1 1,0,0,0,1 1,0,0,0,1 1,0,0,0,1 1,0,0,0,1 1,0,0,0,1
1,3,0,0,1 1,0,0,0,1 0,0,0,0,1 1,3,0,0,1 1,0,0,0,1 1,3,0,0,1 0,0,0,0,1 1,0,0,0,1 1,3,0,0,1
1,0,0,0,1 1,0,0,0,1 1,0,0,0,1 1,0,0,0,1 1,0,0,0,1 1,0,0,0,1 1,0,0,0,1 1,0,0,0,1 1,0,0,0,1
1,0,0,0,1 1,0,0,0,1 1,0,0,0,1 1,0,0,0,1 1,0,0,0,1 1,0,0,0,1 1,0,0,0,1 1,0,0,0,1 1,0,0,0,1
1,0,0,0,1 1,0,0,0,1 1,0,0,0,1 1,0,0,0,1 1,0,0,0,1 1,0,0,0,1 1,0,0,0,1 1,0,0,0,1 1,0,0,0,1
1,0,0,0,1 0,0,0,0,1 0,0,0,0,1 1,0,0,0,1 1,0,0,0,1 1,0,0,0,1 0,0,0,0,1 0,0,0,0,1 1,0,0,0,1