MODE 1
MODE2 3
MODE3 4
DONTINCLUDE 3/0/0
SIZE 7/9
BEACHBALL 0
MONEYBOX 0
TIMEBOMB 0
DROPING 0/0/0
LIMIT 0/35
COLOR LIMIT 6
BUNDLE ABILITY 7
COLOR PERCENT 0/86/87/0/86/83
STARS 5000/30000/60000
COLLECT COUNT 15/15/15/0/0/0
COLLECT ITEMS 2/3/6/0/0/0
TOYS COUNT 0/0/0/0
TOYS ITEMS 1/2/0/0
1,0,0,0,1 1,0,0,0,1 1,0,0,0,1 1,0,0,0,1 1,0,0,0,1 1,0,0,0,1 1,0,0,0,1
1,0,0,0,1 1,0,0,0,1 1,3,0,0,1 1,3,0,0,1 1,3,0,0,1 1,0,0,0,1 1,0,0,0,1
1,3,0,0,1 1,3,0,0,1 1,3,0,0,1 1,3,0,0,1 1,3,0,0,1 1,3,0,0,1 1,3,0,0,1
0,0,0,0,1 0,0,0,0,1 0,0,0,0,1 0,0,0,0,1 0,0,0,0,1 0,0,0,0,1 0,0,0,0,1
1,11,0,0,1 1,11,0,0,1 1,11,0,0,1 1,11,0,0,1 1,11,0,0,1 1,11,0,0,1 1,11,0,0,1
1,11,0,0,1 1,11,0,0,1 1,11,0,0,1 1,11,0,0,1 1,11,0,0,1 1,11,0,0,1 1,11,0,0,1
1,11,0,0,1 1,11,0,0,1 1,4,0,0,1 1,4,0,0,1 1,4,0,0,1 1,11,0,0,1 1,11,0,0,1
1,11,0,0,1 1,4,0,0,1 1,4,0,0,1 1,4,0,0,1 1,4,0,0,1 1,4,0,0,1 1,11,0,0,1
1,4,0,0,1 1,4,0,0,1 1,4,0,0,1 1,4,0,0,1 1,4,0,0,1 1,4,0,0,1 1,4,0,0,1