MODE 1
MODE2 3
MODE3 4
DONTINCLUDE 3/0/0
SIZE 7/9
BEACHBALL 0
MONEYBOX 0
TIMEBOMB 0
DROPING 0/0/0
LIMIT 0/32
COLOR LIMIT 6
BUNDLE ABILITY 0
COLOR PERCENT 100/0/0/100/100/100
STARS 100/5600/8900
COLLECT COUNT 18/18/18/0/0/0
COLLECT ITEMS 1/2/6/0/0/0
TOYS COUNT 0/0/0/0
TOYS ITEMS 1/2/0/0
1,0,0 1,0,0 1,0,0 1,0,0 1,0,0 1,0,0 1,0,0
1,0,0 1,0,0 1,0,0 1,0,0 1,0,0 1,0,0 1,0,0
1,3,0 1,3,0 1,3,0 1,3,0 1,3,0 1,3,0 1,3,0
0,0,0 0,0,0 0,0,0 0,0,0 0,0,0 0,0,0 0,0,0
1,11,0 1,11,0 1,11,0 1,11,0 1,11,0 1,11,0 1,11,0
1,11,0 1,11,0 1,11,0 1,11,0 1,11,0 1,11,0 1,11,0
1,4,0 1,4,0 1,4,0 1,4,0 1,4,0 1,4,0 1,4,0
1,4,0 1,4,0 1,4,0 1,4,0 1,4,0 1,4,0 1,4,0
1,4,0 1,4,0 1,4,0 1,4,0 1,4,0 1,4,0 1,4,0