MODE 3
MODE2 4
MODE3 4
SIZE 9/9
BEACHBALL 0
MONEYBOX 0
TIMEBOMB 0
DROPING 0/0/0
LIMIT 0/40
COLOR LIMIT 6
BUNDLE ABILITY 0
COLOR PERCENT 100/0/0/100/100/100
STARS 100/9600/11200
COLLECT COUNT 0/0/15/0/0/0
COLLECT ITEMS 1/2/6/0/0/0
TOYS COUNT 0/0/0/0
TOYS ITEMS 1/2/0/0
0,0,0 0,0,0 1,0,0 1,0,0 1,0,0 1,0,0 1,0,0 0,0,0 0,0,0
0,0,0 2,8,0 2,8,0 2,8,0 2,8,0 2,8,0 2,8,0 2,8,0 0,0,0
1,0,0 2,8,0 1,0,0 1,0,0 1,0,0 1,0,0 1,0,0 2,8,0 1,0,0
1,0,0 2,8,0 1,0,0 0,0,0 0,0,0 0,0,0 1,0,0 2,8,0 1,0,0
1,0,0 2,8,0 1,0,0 0,0,0 0,0,0 0,0,0 1,0,0 2,8,0 1,0,0
1,0,0 2,8,0 1,0,0 0,0,0 0,0,0 0,0,0 1,0,0 2,8,0 1,0,0
1,0,0 2,8,0 1,0,0 1,0,0 1,0,0 1,0,0 1,0,0 2,8,0 1,0,0
0,0,0 2,8,0 2,8,0 2,8,0 2,8,0 2,8,0 2,8,0 2,8,0 0,0,0
0,0,0 0,0,0 1,0,0 1,0,0 1,0,0 1,0,0 1,0,0 0,0,0 0,0,0