MODE 1
MODE2 3
MODE3 4
DONTINCLUDE 4/0/0
SIZE 7/9
BEACHBALL 0
MONEYBOX 0
TIMEBOMB 0
DROPING 0/0/0
LIMIT 0/40
COLOR LIMIT 6
BUNDLE ABILITY 4
COLOR PERCENT 0/97/94/88/90/95
STARS 5000/30000/65000
COLLECT COUNT 18/18/18/0/0/0
COLLECT ITEMS 2/3/6/0/0/0
TOYS COUNT 0/0/0/0
TOYS ITEMS 1/2/0/0
1,0,0,0,1 1,0,0,0,1 1,0,0,0,1 1,0,0,0,1 1,0,0,0,1 1,0,0,0,1 1,0,0,0,1
1,4,0,0,1 1,4,0,0,1 1,0,0,0,1 1,0,0,0,1 1,0,0,0,1 1,4,0,0,1 1,4,0,0,1
1,3,0,0,1 1,4,0,0,1 1,0,0,0,1 1,0,0,0,1 1,0,0,0,1 1,4,0,0,1 1,3,0,0,1
1,0,0,0,1 1,4,0,0,1 1,0,0,0,1 1,0,0,0,1 1,0,0,0,1 1,4,0,0,1 1,0,0,0,1
1,0,0,0,1 1,3,0,0,1 1,3,0,0,1 1,3,0,0,1 1,3,0,0,1 1,3,0,0,1 1,0,0,0,1
1,0,0,0,1 1,4,0,0,1 1,0,0,0,1 1,0,0,0,1 1,0,0,0,1 1,4,0,0,1 1,0,0,0,1
1,3,0,0,1 1,4,0,0,1 1,0,0,0,1 1,0,0,0,1 1,0,0,0,1 1,4,0,0,1 1,3,0,0,1
1,4,0,0,1 1,4,0,0,1 1,0,0,0,1 1,0,0,0,1 1,0,0,0,1 1,4,0,0,1 1,4,0,0,1
1,0,0,0,1 1,0,0,0,1 1,0,0,0,1 1,0,0,0,1 1,0,0,0,1 1,0,0,0,1 1,0,0,0,1