MODE 1
MODE2 4
MODE3 4
DONTINCLUDE 0/0/0
SIZE 9/8
BEACHBALL 0
MONEYBOX 0
TIMEBOMB 0
DROPING 0/0/0
LIMIT 0/50
COLOR LIMIT 6
BUNDLE ABILITY 3
COLOR PERCENT 95/0/92/100/100/93
STARS 5000/30000/60000
COLLECT COUNT 35/35/0/0/0/0
COLLECT ITEMS 4/5/0/0/0/0
TOYS COUNT 0/0/0/0
TOYS ITEMS 1/2/3/4
1,0,0,0,1 1,0,0,0,1 1,0,0,0,1 1,0,0,0,1 1,0,0,0,1 1,0,0,0,1 1,0,0,0,1 1,0,0,0,1 1,0,0,0,1
1,0,0,0,1 1,0,0,0,1 1,0,0,0,1 1,0,0,0,1 1,0,0,0,1 1,0,0,0,1 1,0,0,0,1 1,0,0,0,1 1,0,0,0,1
1,0,0,0,1 1,0,0,0,1 1,0,0,0,1 1,0,0,0,1 1,0,0,0,1 1,0,0,0,1 1,0,0,0,1 1,0,0,0,1 1,0,0,0,1
1,0,0,0,1 1,0,0,0,1 1,0,0,0,1 1,0,0,0,1 1,0,0,0,1 1,0,0,0,1 1,0,0,0,1 1,0,0,0,1 1,0,0,0,1
1,0,0,0,1 1,0,0,0,1 1,0,0,0,1 1,0,0,0,1 1,7,0,0,1 1,0,0,0,1 1,0,0,0,1 1,0,0,0,1 1,0,0,0,1
1,0,0,0,1 1,0,0,0,1 1,0,0,0,1 1,7,0,0,1 1,7,0,0,1 1,7,0,0,1 1,0,0,0,1 1,0,0,0,1 1,0,0,0,1
1,0,0,0,1 1,0,0,0,1 1,7,0,0,1 1,7,0,0,1 1,7,0,0,1 1,7,0,0,1 1,7,0,0,1 1,0,0,0,1 1,0,0,0,1
1,0,0,0,1 1,7,0,0,1 1,7,0,0,1 1,7,0,0,1 1,7,0,0,1 1,7,0,0,1 1,7,0,0,1 1,7,0,0,1 1,0,0,0,1