MODE 1
MODE2 3
MODE3 4
DONTINCLUDE 7/0/0
SIZE 9/9
BEACHBALL 15
MONEYBOX 0
TIMEBOMB 0
DROPING 0/0/0
LIMIT 0/42
COLOR LIMIT 6
BUNDLE ABILITY 3
COLOR PERCENT 100/59/0/61/58/58
STARS 5000/30000/60000
COLLECT COUNT 15/0/0/0/0/0
COLLECT ITEMS 4/0/0/0/0/0
TOYS COUNT 0/0/0/0
TOYS ITEMS 1/2/3/4
1,0,0,0,1 1,0,0,0,1 1,0,0,0,1 1,0,0,0,1 1,0,0,0,1 1,0,0,0,1 1,0,0,0,1 1,0,0,0,1 1,0,0,0,1
1,0,0,0,1 1,0,0,0,1 1,7,0,0,1 1,7,0,0,1 1,7,0,0,1 1,7,0,0,1 1,7,0,0,1 1,0,0,0,1 1,0,0,0,1
1,0,0,0,1 1,0,0,0,1 1,7,0,0,1 1,8,0,0,1 1,8,0,0,1 1,8,0,0,1 1,7,0,0,1 1,0,0,0,1 1,0,0,0,1
1,0,0,0,1 1,0,0,0,1 1,7,0,0,1 1,8,0,0,1 1,8,0,0,1 1,8,0,0,1 1,7,0,0,1 1,0,0,0,1 1,0,0,0,1
1,0,0,0,1 1,0,0,0,1 1,7,0,0,1 1,8,0,0,1 1,8,0,0,1 1,8,0,0,1 1,7,0,0,1 1,0,0,0,1 1,0,0,0,1
1,0,0,0,1 1,0,0,0,1 1,7,0,0,1 1,8,0,0,1 1,8,0,0,1 1,8,0,0,1 1,7,0,0,1 1,0,0,0,1 1,0,0,0,1
1,0,0,0,1 1,0,0,0,1 1,7,0,0,1 1,8,0,0,1 1,8,0,0,1 1,8,0,0,1 1,7,0,0,1 1,0,0,0,1 1,0,0,0,1
1,0,0,0,1 1,0,0,0,1 1,7,0,0,1 1,7,0,0,1 1,7,0,0,1 1,7,0,0,1 1,7,0,0,1 1,0,0,0,1 1,0,0,0,1
1,0,0,0,1 1,0,0,0,1 1,0,0,0,1 1,0,0,0,1 1,0,0,0,1 1,0,0,0,1 1,0,0,0,1 1,0,0,0,1 1,0,0,0,1