MODE 2
MODE2 4
MODE3 4
DONTINCLUDE 0/0/0
SIZE 7/9
BEACHBALL 0
MONEYBOX 0
TIMEBOMB 0
DROPING 0/0/0
LIMIT 0/42
COLOR LIMIT 6
BUNDLE ABILITY 1
COLOR PERCENT 95/0/94/94/95/95
STARS 5000/30000/60000
COLLECT COUNT 1/1/0/0/0/0
COLLECT ITEMS 1/2/0/0/0/0
TOYS COUNT 1/1/0/0
TOYS ITEMS 1/3/0/0
0,0,0,0,1 1,10,1,0,1 1,0,0,0,1 1,0,0,0,1 1,0,0,0,1 1,10,3,0,1 0,0,0,0,1
0,0,0,0,1 1,4,0,0,1 1,0,0,0,1 1,0,0,0,1 1,0,0,0,1 1,4,0,0,1 0,0,0,0,1
0,0,0,0,1 1,4,0,0,1 1,0,0,0,1 1,0,0,0,1 1,0,0,0,1 1,4,0,0,1 0,0,0,0,1
1,0,0,0,1 1,4,0,0,1 1,0,0,0,1 1,0,0,0,1 1,0,0,0,1 1,4,0,0,1 1,0,0,0,1
1,0,0,0,1 1,4,0,0,1 1,0,0,0,1 0,0,0,0,1 1,0,0,0,1 1,4,0,0,1 1,0,0,0,1
1,0,0,0,1 1,4,0,0,1 1,0,0,0,1 1,0,0,0,1 1,0,0,0,1 1,4,0,0,1 1,0,0,0,1
1,0,0,0,1 1,4,0,0,1 1,0,0,0,1 1,0,0,0,1 1,0,0,0,1 1,4,0,0,1 1,0,0,0,1
1,7,0,0,1 1,4,0,0,1 1,0,0,0,1 1,0,0,0,1 1,0,0,0,1 1,4,0,0,1 1,7,0,0,1
1,7,0,0,1 1,7,0,0,1 1,7,0,0,1 1,7,0,0,1 1,7,0,0,1 1,7,0,0,1 1,7,0,0,1