MODE 2
MODE2 4
MODE3 4
SIZE 7/9
BEACHBALL 0
MONEYBOX 0
TIMEBOMB 0
DROPING 0/0/0
LIMIT 0/40
COLOR LIMIT 6
BUNDLE ABILITY 0
COLOR PERCENT 100/0/100/100/100/100
STARS 100/5800/7000
COLLECT COUNT 1/1/0/0/0/0
COLLECT ITEMS 1/2/0/0/0/0
TOYS COUNT 1/1/0/0
TOYS ITEMS 1/2/0/0
1,10,1 1,0,0 1,0,0 0,0,0 1,0,0 1,0,0 1,10,2
1,4,0 1,0,0 1,0,0 0,0,0 1,0,0 1,0,0 1,4,0
1,4,0 1,0,0 1,0,0 0,0,0 1,0,0 1,0,0 1,4,0
1,4,0 1,0,0 1,0,0 1,0,0 1,0,0 1,0,0 1,4,0
1,4,0 1,0,0 1,0,0 1,0,0 1,0,0 1,0,0 1,4,0
1,4,0 1,0,0 1,0,0 1,0,0 1,0,0 1,0,0 1,4,0
1,4,0 1,0,0 1,0,0 1,0,0 1,0,0 1,0,0 1,4,0
1,7,0 1,0,0 1,0,0 1,0,0 1,0,0 1,0,0 1,7,0
1,7,0 1,7,0 1,7,0 1,7,0 1,7,0 1,7,0 1,7,0