MODE 1
MODE2 4
MODE3 4
DONTINCLUDE 0/0/0
SIZE 9/9
BEACHBALL 0
MONEYBOX 0
TIMEBOMB 0
DROPING 0/0/0
LIMIT 0/30
COLOR LIMIT 6
BUNDLE ABILITY 6
COLOR PERCENT 89/85/0/81/87/87
STARS 10000/10500/11000
COLLECT COUNT 11/33/33/0/0/0
COLLECT ITEMS 1/2/5/0/0/0
TOYS COUNT 0/0/0/0
TOYS ITEMS 1/3/0/0
0,0,0,0,1 0,0,0,0,1 1,0,0,0,1 0,0,0,0,1 1,11,4,0,1 0,0,0,0,1 1,0,0,0,1 0,0,0,0,1 0,0,0,0,1
0,0,0,0,1 1,0,0,0,1 1,0,0,0,1 1,11,4,0,1 1,0,0,0,1 1,0,0,0,1 1,0,0,0,1 1,11,4,0,1 0,0,0,0,1
1,11,4,0,1 1,11,4,0,1 1,0,0,0,1 1,0,0,0,1 1,0,0,0,1 1,0,0,0,1 1,11,4,0,1 1,0,0,0,1 1,0,0,0,1
0,0,0,0,1 1,0,0,0,1 1,0,0,0,1 1,0,0,0,1 1,0,0,0,1 1,0,0,0,1 1,0,0,0,1 1,0,0,0,1 0,0,0,0,1
1,0,0,0,1 1,0,0,0,1 1,0,0,0,1 1,0,0,0,1 1,11,4,0,1 1,12,2,0,1 1,12,4,0,1 1,0,0,0,1 1,11,4,0,1
0,0,0,0,1 1,0,0,0,1 1,0,0,0,1 1,0,0,0,1 1,0,0,0,1 1,0,0,0,1 1,0,0,0,1 1,0,0,0,1 0,0,0,0,1
1,11,4,0,1 1,0,0,0,1 1,0,0,0,1 1,11,4,0,1 1,0,0,0,1 1,0,0,0,1 1,0,0,0,1 1,0,0,0,1 1,11,4,0,1
0,0,0,0,1 1,0,0,0,1 1,0,0,0,1 1,0,0,0,1 1,0,0,0,1 1,0,0,0,1 1,0,0,0,1 1,0,0,0,1 0,0,0,0,1
0,0,0,0,1 0,0,0,0,1 1,11,4,0,1 0,0,0,0,1 1,0,0,0,1 0,0,0,0,1 1,0,0,0,1 0,0,0,0,1 0,0,0,0,1