MODE 1
MODE2 4
MODE3 4
SIZE 9/9
BEACHBALL 0
MONEYBOX 0
TIMEBOMB 0
DROPING 0/0/0
LIMIT 0/30
COLOR LIMIT 6
COLOR PERCENT 30/0/100/30/100/100
STARS 1000/1600/2200
COLLECT COUNT 10/35/35/0/0/0
COLLECT ITEMS 5/3/6/0/0/0
TOYS COUNT 0/0/0/0
TOYS ITEMS 1/3/0/0
0,0,0 0,0,0 1,0,0 0,0,0 1,0,0 0,0,0 1,0,0 0,0,0 0,0,0
0,0,0 1,0,0 1,0,0 1,0,0 1,0,0 1,0,0 1,0,0 1,0,0 0,0,0
1,0,0 1,0,0 1,0,0 1,0,0 1,0,0 1,0,0 1,0,0 1,0,0 1,0,0
0,0,0 1,0,0 1,0,0 1,0,0 1,0,0 1,0,0 1,0,0 1,0,0 0,0,0
1,0,0 1,0,0 1,0,0 1,0,0 1,0,0 1,0,0 1,0,0 1,0,0 1,0,0
0,0,0 1,0,0 1,0,0 1,0,0 1,0,0 1,0,0 1,0,0 1,0,0 0,0,0
1,0,0 1,0,0 1,0,0 1,0,0 1,0,0 1,0,0 1,0,0 1,0,0 1,0,0
0,0,0 1,0,0 1,0,0 1,0,0 1,0,0 1,0,0 1,0,0 1,0,0 0,0,0
0,0,0 0,0,0 1,0,0 0,0,0 1,0,0 0,0,0 1,0,0 0,0,0 0,0,0