MODE 3
MODE2 4
MODE3 4
DONTINCLUDE 4/0/0
SIZE 9/9
BEACHBALL 0
MONEYBOX 0
TIMEBOMB 0
DROPING 0/0/0
LIMIT 0/45
COLOR LIMIT 6
BUNDLE ABILITY 1
COLOR PERCENT 0/94/86/91/93/94
STARS 5000/30000/60000
COLLECT COUNT 0/0/0/0/0/0
COLLECT ITEMS 1/2/0/0/0/0
TOYS COUNT 0/0/0/0
TOYS ITEMS 1/2/0/0
2,0,0,0,1 1,0,0,0,1 2,0,0,0,1 1,0,0,0,1 2,0,0,0,1 1,0,0,0,1 2,0,0,0,1 1,0,0,0,1 2,0,0,0,1
1,0,0,0,1 2,0,0,0,1 1,0,0,0,1 2,0,0,0,1 1,0,0,0,1 2,0,0,0,1 1,0,0,0,1 2,0,0,0,1 1,0,0,0,1
2,0,0,0,1 1,0,0,0,1 2,0,0,0,1 1,0,0,0,1 2,0,0,0,1 1,0,0,0,1 2,0,0,0,1 1,0,0,0,1 2,0,0,0,1
1,7,0,0,1 2,0,0,0,1 1,7,0,0,1 2,0,0,0,1 1,7,0,0,1 2,0,0,0,1 1,7,0,0,1 2,0,0,0,1 1,7,0,0,1
2,0,0,0,1 1,7,0,0,1 2,0,0,0,1 1,7,0,0,1 2,0,0,0,1 1,7,0,0,1 2,0,0,0,1 1,7,0,0,1 2,0,0,0,1
1,7,0,0,1 2,0,0,0,1 1,7,0,0,1 2,0,0,0,1 1,7,0,0,1 2,0,0,0,1 1,7,0,0,1 2,0,0,0,1 1,7,0,0,1
2,0,0,0,1 1,7,0,0,1 2,0,0,0,1 1,7,0,0,1 2,0,0,0,1 1,7,0,0,1 2,0,0,0,1 1,7,0,0,1 2,0,0,0,1
1,7,0,0,1 2,0,0,0,1 1,7,0,0,1 2,0,0,0,1 1,7,0,0,1 2,0,0,0,1 1,7,0,0,1 2,0,0,0,1 1,7,0,0,1
2,0,0,0,1 1,7,0,0,1 2,0,0,0,1 1,7,0,0,1 2,0,0,0,1 1,7,0,0,1 2,0,0,0,1 1,7,0,0,1 2,0,0,0,1