MODE 2
MODE2 4
MODE3 4
DONTINCLUDE 0/0/0
SIZE 9/8
BEACHBALL 0
MONEYBOX 0
TIMEBOMB 0
DROPING 0/0/0
LIMIT 0/60
COLOR LIMIT 6
BUNDLE ABILITY 4
COLOR PERCENT 100/0/100/100/100/100
STARS 5000/35000/70000
COLLECT COUNT 25/30/24/24/0/0
COLLECT ITEMS 1/4/5/6/0/0
TOYS COUNT 1/1/1/0
TOYS ITEMS 1/2/3/0
0,0,0,0,1 1,10,1,0,1 1,0,0,0,1 1,0,0,0,1 1,10,2,0,1 1,0,0,0,1 1,0,0,0,1 1,10,3,0,1 0,0,0,0,1
1,0,0,0,1 1,0,0,0,1 1,0,0,0,1 1,0,0,0,1 1,0,0,0,1 1,0,0,0,1 1,0,0,0,1 1,0,0,0,1 1,0,0,0,1
1,4,0,0,1 1,4,0,0,1 1,4,0,0,1 1,4,0,0,1 1,4,0,0,1 1,4,0,0,1 1,4,0,0,1 1,4,0,0,1 1,4,0,0,1
1,4,0,0,1 1,4,0,0,1 1,4,0,0,1 1,4,0,0,1 1,4,0,0,1 1,4,0,0,1 1,4,0,0,1 1,4,0,0,1 1,4,0,0,1
1,4,0,0,1 1,4,0,0,1 1,4,0,0,1 1,4,0,0,1 1,4,0,0,1 1,4,0,0,1 1,4,0,0,1 1,4,0,0,1 1,4,0,0,1
1,7,0,0,1 1,7,0,0,1 1,7,0,0,1 1,7,0,0,1 1,7,0,0,1 1,7,0,0,1 1,7,0,0,1 1,7,0,0,1 1,7,0,0,1
1,7,0,0,1 1,8,0,0,1 1,8,0,0,1 1,8,0,0,1 1,8,0,0,1 1,8,0,0,1 1,8,0,0,1 1,8,0,0,1 1,7,0,0,1
1,7,0,0,1 1,7,0,0,1 1,7,0,0,1 1,7,0,0,1 1,7,0,0,1 1,7,0,0,1 1,7,0,0,1 1,7,0,0,1 1,7,0,0,1