MODE 1
MODE2 3
MODE3 4
DONTINCLUDE 7/0/0
SIZE 9/9
BEACHBALL 0
MONEYBOX 0
TIMEBOMB 0
DROPING 0/0/0
LIMIT 0/32
COLOR LIMIT 6
BUNDLE ABILITY 2
COLOR PERCENT 95/0/0/96/97/96
STARS 3500/25000/50000
COLLECT COUNT 30/30/0/0/0/0
COLLECT ITEMS 1/5/0/0/0/0
TOYS COUNT 0/0/0/0
TOYS ITEMS 1/2/3/0
1,0,0,0,1 1,0,0,0,1 1,0,0,0,1 1,0,0,0,1 1,0,0,0,1 1,0,0,0,1 1,0,0,0,1 1,0,0,0,1 1,0,0,0,1
1,0,0,0,1 1,0,0,0,1 1,0,0,0,1 1,0,0,0,1 1,0,0,0,1 1,0,0,0,1 1,0,0,0,1 1,0,0,0,1 1,0,0,0,1
1,0,0,0,1 1,3,0,0,1 1,0,0,0,1 1,3,0,0,1 1,0,0,0,1 1,3,0,0,1 1,0,0,0,1 1,3,0,0,1 1,0,0,0,1
1,0,0,0,1 0,0,0,0,1 1,0,0,0,1 0,0,0,0,1 1,0,0,0,1 0,0,0,0,1 1,0,0,0,1 0,0,0,0,1 1,0,0,0,1
1,0,0,0,1 1,3,0,0,1 1,0,0,0,1 1,3,0,0,1 1,0,0,0,1 1,3,0,0,1 1,0,0,0,1 1,3,0,0,1 1,0,0,0,1
1,0,0,0,1 0,0,0,0,1 1,0,0,0,1 0,0,0,0,1 1,0,0,0,1 0,0,0,0,1 1,0,0,0,1 0,0,0,0,1 1,0,0,0,1
1,7,0,0,1 1,3,0,0,1 1,7,0,0,1 1,3,0,0,1 1,7,0,0,1 1,3,0,0,1 1,7,0,0,1 1,3,0,0,1 1,7,0,0,1
1,7,0,0,1 1,7,0,0,1 1,7,0,0,1 1,7,0,0,1 1,7,0,0,1 1,7,0,0,1 1,7,0,0,1 1,7,0,0,1 1,7,0,0,1
1,7,0,0,1 0,0,0,0,1 1,7,0,0,1 0,0,0,0,1 1,7,0,0,1 0,0,0,0,1 1,7,0,0,1 0,0,0,0,1 1,7,0,0,1