MODE 3
MODE2 4
MODE3 4
TAG 0
DONTINCLUDE 0/0/0
SIZE 9/9
BEACHBALL 15
MONEYBOX 0
TIMEBOMB 0
DROPING 0/0/0
LIMIT 0/30
COLOR LIMIT 6
BUNDLE ABILITY 9
COLOR PERCENT 95/0/0/92/89/94
STARS 3000/25000/45000
COLLECT COUNT 0/0/0/0/0/0
COLLECT ITEMS 1/2/0/0/0/0
TOYS COUNT 0/0/0/0
TOYS ITEMS 1/2/3/4
1,0,0,0,1 1,0,0,0,1 1,0,0,0,1 1,0,0,0,1 1,0,0,0,1 1,0,0,0,1 1,0,0,0,1 1,0,0,0,1 1,0,0,0,1
1,0,0,0,1 1,0,0,0,1 1,0,0,0,1 1,0,0,0,1 1,0,0,0,1 1,0,0,0,1 1,0,0,0,1 1,0,0,0,1 1,0,0,0,1
1,0,0,0,1 1,8,0,0,1 1,9,0,0,1 1,0,0,0,1 1,0,0,0,1 1,0,0,0,1 1,9,3,0,1 1,8,0,0,1 1,0,0,0,1
1,0,0,0,1 1,8,0,0,1 1,9,0,0,1 1,0,0,0,1 1,0,0,0,1 1,0,0,0,1 1,9,3,0,1 1,8,0,0,1 1,0,0,0,1
1,0,0,0,1 1,8,0,0,1 1,9,0,0,1 1,0,0,0,1 1,0,0,0,1 1,0,0,0,1 1,9,3,0,1 1,8,0,0,1 1,0,0,0,1
1,0,0,0,1 1,8,0,0,1 1,9,0,0,1 1,0,0,0,1 1,0,0,0,1 1,0,0,0,1 1,9,3,0,1 1,8,0,0,1 1,0,0,0,1
1,0,0,0,1 1,8,0,0,1 1,9,0,0,1 1,0,0,0,1 1,0,0,0,1 1,0,0,0,1 1,9,3,0,1 1,8,0,0,1 1,0,0,0,1
0,0,0,0,1 0,0,0,0,1 1,8,0,0,1 1,8,0,0,1 1,8,0,0,1 1,8,0,0,1 1,8,0,0,1 0,0,0,0,1 0,0,0,0,1
0,0,0,0,1 0,0,0,0,1 1,9,4,0,1 1,9,4,0,1 1,9,4,0,1 1,9,4,0,1 1,9,4,0,1 0,0,0,0,1 0,0,0,0,1