MODE 3
MODE2 1
MODE3 4
DONTINCLUDE 0/0/0
SIZE 8/8
BEACHBALL 0
MONEYBOX 0
TIMEBOMB 0
DROPING 0/0/0
LIMIT 0/60
COLOR LIMIT 6
BUNDLE ABILITY 0
COLOR PERCENT 100/100/100/100/100/100
STARS 100/5500/7200
COLLECT COUNT 32/32/0/0/0/0
COLLECT ITEMS 5/6/0/0/0/0
TOYS COUNT 0/0/0/0
TOYS ITEMS 1/2/3/4
1,0,0 1,0,0 1,0,0 1,0,0 1,0,0 1,0,0 1,0,0 1,0,0
1,11,0 1,11,0 1,11,0 1,11,0 1,11,0 1,11,0 1,11,0 1,0,0
1,9,0 1,9,0 1,9,0 1,9,0 1,9,0 1,9,0 1,11,0 1,0,0
1,9,1 1,9,1 1,9,1 1,9,1 1,9,1 1,9,0 1,11,0 1,0,0
1,9,5 1,9,5 1,9,5 1,9,5 1,9,1 1,9,0 1,11,0 1,0,0
1,9,4 1,9,4 1,9,4 1,9,5 1,9,1 1,9,0 1,11,0 1,0,0
1,9,3 1,9,3 1,9,4 1,9,5 1,9,1 1,9,0 1,11,0 1,0,0
1,9,2 1,9,3 1,9,4 1,9,5 1,9,1 1,9,0 1,11,0 1,0,0