MODE 3
MODE2 1
MODE3 4
DONTINCLUDE 0/0/0
SIZE 8/8
BEACHBALL 0
MONEYBOX 0
TIMEBOMB 0
DROPING 0/0/0
LIMIT 0/60
COLOR LIMIT 6
BUNDLE ABILITY 11
COLOR PERCENT 100/92/93/96/98/97
STARS 5000/35000/60000
COLLECT COUNT 32/32/0/0/0/0
COLLECT ITEMS 5/6/0/0/0/0
TOYS COUNT 0/0/0/0
TOYS ITEMS 1/2/3/4
1,0,0,0,1 1,0,0,0,1 1,0,0,0,1 1,0,0,0,1 1,0,0,0,1 1,0,0,0,1 1,0,0,0,1 1,0,0,0,1
1,0,0,0,1 1,0,0,0,1 1,0,0,0,1 1,0,0,0,1 1,0,0,0,1 1,0,0,0,1 1,0,0,0,1 1,0,0,0,1
1,0,0,0,1 1,0,0,0,1 1,0,0,0,1 1,0,0,0,1 1,0,0,0,1 1,0,0,0,1 1,0,0,0,1 1,9,5,0,1
1,0,0,0,1 1,0,0,0,1 1,0,0,0,1 1,0,0,0,1 1,0,0,0,1 1,0,0,0,1 1,9,5,0,1 1,9,4,0,1
1,0,0,0,1 1,0,0,0,1 1,0,0,0,1 1,0,0,0,1 1,0,0,0,1 1,9,5,0,1 1,9,4,0,1 1,9,2,0,1
1,0,0,0,1 1,0,0,0,1 1,0,0,0,1 1,0,0,0,1 1,9,5,0,1 1,9,4,0,1 1,9,2,0,1 1,9,3,0,1
1,0,0,0,1 1,0,0,0,1 1,0,0,0,1 1,9,5,0,1 1,9,4,0,1 1,9,2,0,1 1,9,3,0,1 1,9,0,0,1
1,0,0,0,1 1,0,0,0,1 1,9,5,0,1 1,9,4,0,1 1,9,2,0,1 1,9,3,0,1 1,9,0,0,1 1,9,1,0,1