MODE 2
MODE2 4
MODE3 4
DONTINCLUDE 0/0/0
SIZE 9/9
BEACHBALL 0
MONEYBOX 0
TIMEBOMB 0
DROPING 0/0/0
LIMIT 0/40
COLOR LIMIT 6
BUNDLE ABILITY 3
COLOR PERCENT 92/0/0/98/93/92
STARS 5000/35000/70000
COLLECT COUNT 0/0/0/0/0/0
COLLECT ITEMS 1/2/0/0/0/0
TOYS COUNT 1/1/1/0
TOYS ITEMS 1/2/3/0
1,10,1,0,1 1,11,0,0,1 1,11,0,0,1 1,0,0,0,1 1,10,2,0,1 1,0,0,0,1 1,11,0,0,1 1,11,0,0,1 1,10,3,0,1
1,0,0,0,1 1,11,0,0,1 1,11,0,0,1 1,0,0,0,1 1,0,0,0,1 1,0,0,0,1 1,11,0,0,1 1,11,0,0,1 1,0,0,0,1
1,0,0,0,1 1,11,0,0,1 1,11,0,0,1 1,0,0,0,1 1,0,0,0,1 1,0,0,0,1 1,11,0,0,1 1,11,0,0,1 1,0,0,0,1
1,0,0,0,1 1,11,0,0,1 1,11,0,0,1 1,0,0,0,1 1,0,0,0,1 1,0,0,0,1 1,11,0,0,1 1,11,0,0,1 1,0,0,0,1
1,4,0,0,1 1,11,0,0,1 1,11,0,0,1 1,0,0,0,1 1,0,0,0,1 1,0,0,0,1 1,11,0,0,1 1,11,0,0,1 1,4,0,0,1
1,9,0,0,1 1,11,0,0,1 1,11,0,0,1 1,9,5,0,1 1,0,0,0,1 1,9,5,0,1 1,11,0,0,1 1,11,0,0,1 1,9,2,0,1
1,9,0,0,1 1,11,0,0,1 1,11,0,0,1 1,9,5,0,1 1,0,0,0,1 1,9,5,0,1 1,11,0,0,1 1,11,0,0,1 1,9,2,0,1
1,9,0,0,1 1,11,0,0,1 1,11,0,0,1 1,9,5,0,1 1,0,0,0,1 1,9,5,0,1 1,11,0,0,1 1,11,0,0,1 1,9,2,0,1
1,9,0,0,1 1,11,0,0,1 1,11,0,0,1 1,9,5,0,1 1,0,0,0,1 1,9,5,0,1 1,11,0,0,1 1,11,0,0,1 1,9,2,0,1