MODE 3
MODE2 4
MODE3 4
DONTINCLUDE 0/0/0
SIZE 9/9
BEACHBALL 0
MONEYBOX 0
TIMEBOMB 0
DROPING 0/0/0
LIMIT 0/30
COLOR LIMIT 6
BUNDLE ABILITY 5
COLOR PERCENT 81/0/0/80/83/88
STARS 5000/30000/60000
COLLECT COUNT 0/0/0/0/0/0
COLLECT ITEMS 1/2/0/0/0/0
TOYS COUNT 0/0/0/0
TOYS ITEMS 1/2/3/0
1,0,0,0,1 1,0,0,0,1 1,0,0,0,1 1,0,0,0,1 1,0,0,0,1 1,0,0,0,1 1,0,0,0,1 1,0,0,0,1 1,0,0,0,1
1,0,0,0,1 1,0,0,0,1 1,0,0,0,1 1,0,0,0,1 1,0,0,0,1 1,0,0,0,1 1,0,0,0,1 1,0,0,0,1 1,0,0,0,1
1,4,0,0,1 1,4,0,0,1 1,4,0,0,1 1,9,3,0,1 1,9,3,0,1 1,9,3,0,1 1,4,0,0,1 1,4,0,0,1 1,4,0,0,1
0,0,0,0,1 1,0,0,0,1 1,0,0,0,1 1,0,0,0,1 1,0,0,0,1 1,0,0,0,1 1,0,0,0,1 1,0,0,0,1 0,0,0,0,1
0,0,0,0,1 1,0,0,0,1 1,0,0,0,1 1,0,0,0,1 1,0,0,0,1 1,0,0,0,1 1,0,0,0,1 1,0,0,0,1 0,0,0,0,1
0,0,0,0,1 1,0,0,0,1 1,0,0,0,1 1,9,4,0,1 1,9,4,0,1 1,9,4,0,1 1,0,0,0,1 1,0,0,0,1 0,0,0,0,1
1,9,0,0,1 1,0,0,0,1 1,0,0,0,1 1,9,4,0,1 1,9,4,0,1 1,9,4,0,1 1,0,0,0,1 1,0,0,0,1 1,9,0,0,1
1,9,0,0,1 1,0,0,0,1 1,0,0,0,1 1,0,0,0,1 1,0,0,0,1 1,0,0,0,1 1,0,0,0,1 1,0,0,0,1 1,9,0,0,1
1,9,0,0,1 1,9,0,0,1 1,9,0,0,1 0,0,0,0,1 0,0,0,0,1 0,0,0,0,1 1,9,0,0,1 1,9,0,0,1 1,9,0,0,1