MODE 3
MODE2 4
MODE3 4
DONTINCLUDE 0/0/0
SIZE 9/9
BEACHBALL 15
MONEYBOX 0
TIMEBOMB 0
DROPING 0/0/0
LIMIT 0/45
COLOR LIMIT 6
BUNDLE ABILITY 2
COLOR PERCENT 90/0/84/91/85/90
STARS 5000/30000/60000
COLLECT COUNT 15/35/0/0/0/0
COLLECT ITEMS 1/5/0/0/0/0
TOYS COUNT 0/0/0/0
TOYS ITEMS 1/2/3/0
1,0,0,0,1 1,0,0,0,1 1,0,0,0,1 1,0,0,0,1 1,0,0,0,1 1,0,0,0,1 1,0,0,0,1 1,0,0,0,1 1,0,0,0,1
1,0,0,0,1 1,0,0,0,1 1,0,0,0,1 1,0,0,0,1 1,0,0,0,1 1,0,0,0,1 1,0,0,0,1 1,0,0,0,1 1,0,0,0,1
0,0,0,0,1 1,0,0,0,1 1,0,0,0,1 1,0,0,0,1 1,0,0,0,1 1,0,0,0,1 1,0,0,0,1 1,0,0,0,1 0,0,0,0,1
0,0,0,0,1 1,4,1,0,1 1,4,1,0,1 1,4,1,0,1 1,4,1,0,1 1,4,1,0,1 1,4,1,0,1 1,4,1,0,1 0,0,0,0,1
0,0,0,0,1 1,0,0,0,1 1,0,0,0,1 1,8,0,0,1 1,8,0,0,1 1,8,0,0,1 1,0,0,0,1 1,0,0,0,1 0,0,0,0,1
1,0,0,0,1 1,0,0,0,1 1,0,0,0,1 1,8,0,0,1 1,8,0,0,1 1,8,0,0,1 1,0,0,0,1 1,0,0,0,1 1,0,0,0,1
1,0,0,0,1 1,0,0,0,1 1,0,0,0,1 1,8,0,0,1 1,8,0,0,1 1,8,0,0,1 1,0,0,0,1 1,0,0,0,1 1,0,0,0,1
1,4,1,0,1 1,4,1,0,1 1,4,1,0,1 1,4,1,0,1 1,4,1,0,1 1,4,1,0,1 1,4,1,0,1 1,4,1,0,1 1,4,1,0,1
1,8,0,0,1 1,8,0,0,1 1,8,0,0,1 0,0,0,0,1 0,0,0,0,1 0,0,0,0,1 1,8,0,0,1 1,8,0,0,1 1,8,0,0,1