MODE 3
MODE2 4
MODE3 4
DONTINCLUDE 0/0/0
SIZE 9/9
BEACHBALL 0
MONEYBOX 0
TIMEBOMB 0
DROPING 0/0/0
LIMIT 0/40
COLOR LIMIT 6
BUNDLE ABILITY 7
COLOR PERCENT 95/0/0/95/95/91
STARS 5000/35000/65000
COLLECT COUNT 0/0/0/0/0/0
COLLECT ITEMS 1/2/0/0/0/0
TOYS COUNT 0/0/0/0
TOYS ITEMS 1/2/0/0
1,0,0,0,1 1,0,0,0,1 1,0,0,0,1 1,0,0,0,1 0,0,0,0,1 1,0,0,0,1 1,0,0,0,1 1,0,0,0,1 1,0,0,0,1
1,0,0,0,1 1,0,0,0,1 1,0,0,0,1 1,0,0,0,1 0,0,0,0,1 1,0,0,0,1 1,0,0,0,1 1,0,0,0,1 1,0,0,0,1
1,0,0,0,1 1,0,0,0,1 1,0,0,0,1 1,0,0,0,1 0,0,0,0,1 1,9,4,0,1 1,9,4,0,1 1,9,4,0,1 1,9,4,0,1
1,4,1,0,1 1,4,1,0,1 1,4,1,0,1 1,4,1,0,1 0,0,0,0,1 1,9,0,0,1 1,9,0,0,1 1,9,0,0,1 1,9,0,0,1
0,0,0,0,1 0,0,0,0,1 0,0,0,0,1 0,0,0,0,1 0,0,0,0,1 0,0,0,0,1 0,0,0,0,1 0,0,0,0,1 0,0,0,0,1
1,0,0,0,1 1,0,0,0,1 1,0,0,0,1 1,0,0,0,1 0,0,0,0,1 1,0,0,0,1 1,0,0,0,1 1,0,0,0,1 1,0,0,0,1
1,0,0,0,1 1,0,0,0,1 1,0,0,0,1 1,0,0,0,1 0,0,0,0,1 1,9,4,0,1 1,9,4,0,1 1,9,4,0,1 1,9,4,0,1
1,0,0,0,1 1,0,0,0,1 1,0,0,0,1 1,0,0,0,1 0,0,0,0,1 1,9,0,0,1 1,9,0,0,1 1,9,0,0,1 1,9,0,0,1
1,4,1,0,1 1,4,1,0,1 1,4,1,0,1 1,4,1,0,1 0,0,0,0,1 1,0,0,0,1 1,0,0,0,1 1,0,0,0,1 1,0,0,0,1