MODE 3
MODE2 4
MODE3 4
DONTINCLUDE 0/0/0
SIZE 9/9
BEACHBALL 0
MONEYBOX 0
TIMEBOMB 10
DROPING 0/0/5
LIMIT 0/30
COLOR LIMIT 6
BUNDLE ABILITY 3
COLOR PERCENT 100/0/100/100/100/100
STARS 5000/30000/60000
COLLECT COUNT 1/2/0/0/0/0
COLLECT ITEMS 1/2/0/0/0/0
TOYS COUNT 0/0/0/0
TOYS ITEMS 1/2/0/0
0,0,0,0,1 1,0,0,0,1 1,0,0,0,1 1,0,0,0,1 0,0,0,0,1 1,0,0,0,1 1,0,0,0,1 1,0,0,0,1 0,0,0,0,1
1,0,0,0,1 1,11,5,0,1 1,11,5,0,1 1,11,5,0,1 1,0,0,0,1 1,11,4,0,1 1,11,4,0,1 1,11,4,0,1 1,0,0,0,1
1,0,0,0,1 1,11,5,0,1 5,0,5,10,1 1,11,5,0,1 1,0,0,0,1 1,11,4,0,1 5,0,4,10,1 1,11,4,0,1 1,0,0,0,1
1,0,0,0,1 1,0,0,0,1 1,0,0,0,1 1,0,0,0,1 1,0,0,0,1 1,0,0,0,1 1,0,0,0,1 1,0,0,0,1 1,0,0,0,1
1,0,0,0,1 5,0,3,10,1 1,0,0,0,1 1,0,0,0,1 1,0,0,0,1 1,11,4,0,1 1,11,4,0,1 5,0,4,10,1 1,0,0,0,1
1,11,3,0,1 1,11,3,0,1 1,0,0,0,1 1,0,0,0,1 1,0,0,0,1 1,0,0,0,1 1,0,0,0,1 1,0,0,0,1 1,0,0,0,1
1,11,2,0,1 1,11,2,0,1 5,0,1,10,1 1,0,0,0,1 1,0,0,0,1 1,0,0,0,1 5,0,2,10,1 1,0,0,0,1 1,0,0,0,1
1,0,0,0,1 1,0,0,0,1 1,0,0,0,1 1,0,0,0,1 1,0,0,0,1 1,0,0,0,1 1,11,2,0,1 1,0,0,0,1 1,0,0,0,1
1,0,0,0,1 1,0,0,0,1 1,0,0,0,1 0,0,0,0,1 0,0,0,0,1 0,0,0,0,1 1,11,2,0,1 1,0,0,0,1 1,0,0,0,1