MODE 1
MODE2 4
MODE3 4
TAG 0
DONTINCLUDE 0/0/0
SIZE 9/9
BEACHBALL 0
MONEYBOX 0
TIMEBOMB 0
DROPING 0/0/5
LIMIT 0/30
COLOR LIMIT 6
BUNDLE ABILITY 6
COLOR PERCENT 94/0/96/97/95/97
STARS 5000/30000/60000
COLLECT COUNT 30/30/30/30/0/0
COLLECT ITEMS 1/4/3/5/0/0
TOYS COUNT 0/0/0/0
TOYS ITEMS 1/2/0/0
0,0,0,0,1 1,0,0,0,1 1,0,0,0,1 1,0,0,0,1 0,0,0,0,1 1,0,0,0,1 1,0,0,0,1 1,0,0,0,1 0,0,0,0,1
1,0,0,0,1 1,11,5,0,1 1,11,5,0,1 1,11,5,0,1 1,0,0,0,1 1,11,4,0,1 1,11,4,0,1 1,11,4,0,1 1,0,0,0,1
1,0,0,0,1 1,11,5,0,1 5,0,5,10,1 1,11,5,0,1 1,0,0,0,1 1,11,4,0,1 5,0,4,10,1 1,11,4,0,1 1,0,0,0,1
1,0,0,0,1 1,0,0,0,1 1,0,0,0,1 1,0,0,0,1 1,0,0,0,1 1,0,0,0,1 1,0,0,0,1 1,0,0,0,1 1,0,0,0,1
1,0,0,0,1 5,0,3,10,1 1,0,0,0,1 1,0,0,0,1 1,0,0,0,1 1,11,4,0,1 1,11,4,0,1 5,0,4,10,1 1,0,0,0,1
1,11,3,0,1 1,11,3,0,1 1,0,0,0,1 1,0,0,0,1 1,0,0,0,1 1,0,0,0,1 1,0,0,0,1 1,0,0,0,1 1,0,0,0,1
1,11,1,0,1 1,11,1,0,1 5,0,1,10,1 1,0,0,0,1 1,0,0,0,1 1,0,0,0,1 5,0,1,10,1 1,0,0,0,1 1,0,0,0,1
1,0,0,0,1 1,0,0,0,1 1,0,0,0,1 1,0,0,0,1 1,0,0,0,1 1,0,0,0,1 1,11,1,0,1 1,0,0,0,1 1,0,0,0,1
1,0,0,0,1 1,0,0,0,1 1,0,0,0,1 0,0,0,0,1 0,0,0,0,1 0,0,0,0,1 1,11,1,0,1 1,0,0,0,1 1,0,0,0,1