MODE 3
MODE2 4
MODE3 4
TAG 1
DONTINCLUDE 0/0/0
SIZE 9/9
BEACHBALL 0
MONEYBOX 0
TIMEBOMB 0
DROPING 0/0/0
LIMIT 0/45
COLOR LIMIT 6
BUNDLE ABILITY 12
COLOR PERCENT 92/0/94/92/95/93
STARS 6000/30000/60000
COLLECT COUNT 0/0/0/0/0/0
COLLECT ITEMS 1/2/0/0/0/0
TOYS COUNT 0/0/0/0
TOYS ITEMS 1/2/0/0
0,0,0,0,1 1,0,0,0,1 1,0,0,0,1 0,0,0,0,1 0,0,0,0,1 0,0,0,0,1 1,0,0,0,1 1,0,0,0,1 0,0,0,0,1
0,0,0,0,1 1,0,0,0,1 1,0,0,0,1 1,0,0,0,1 1,0,0,0,1 1,0,0,0,1 1,0,0,0,1 1,0,0,0,1 0,0,0,0,1
0,0,0,0,1 1,0,0,0,1 1,0,0,0,1 1,0,0,0,1 1,0,0,0,1 1,0,0,0,1 1,0,0,0,1 1,0,0,0,1 0,0,0,0,1
1,0,0,0,1 1,0,0,0,1 1,0,0,0,1 1,0,0,0,1 1,0,0,0,1 1,0,0,0,1 1,0,0,0,1 1,0,0,0,1 1,0,0,0,1
1,0,0,0,1 1,0,0,0,1 1,0,0,0,1 1,0,0,0,1 1,0,0,0,1 1,0,0,0,1 1,0,0,0,1 1,0,0,0,1 1,0,0,0,1
1,0,0,0,1 1,0,0,0,1 1,0,0,0,1 5,0,6,35,1 5,0,1,35,1 5,0,6,35,1 1,0,0,0,1 1,0,0,0,1 1,0,0,0,1
1,0,0,0,1 1,0,0,0,1 5,0,1,35,1 1,4,1,0,1 1,4,1,0,1 1,4,1,0,1 5,0,1,35,1 1,0,0,0,1 1,0,0,0,1
5,0,4,35,1 5,0,5,35,1 1,4,1,0,1 1,4,1,0,1 1,4,1,0,1 1,4,1,0,1 1,4,1,0,1 5,0,5,35,1 5,0,4,35,1
5,0,3,35,1 1,4,1,0,1 1,4,1,0,1 1,4,1,0,1 1,4,1,0,1 1,4,1,0,1 1,4,1,0,1 1,4,1,0,1 5,0,3,35,1