MODE 2
MODE2 4
MODE3 4
DONTINCLUDE 0/0/0
SIZE 9/9
BEACHBALL 0
MONEYBOX 0
TIMEBOMB 0
DROPING 0/0/0
LIMIT 0/45
COLOR LIMIT 6
BUNDLE ABILITY 6
COLOR PERCENT 100/0/100/100/100/100
STARS 5000/30000/60000
COLLECT COUNT 20/25/0/0/0/0
COLLECT ITEMS 1/2/0/0/0/0
TOYS COUNT 1/0/0/0
TOYS ITEMS 1/0/0/0
1,0,0,0,1 1,0,0,0,1 1,0,0,0,1 1,0,0,0,1 1,0,0,0,1 1,0,0,0,1 1,0,0,0,1 1,0,0,0,1 1,0,0,0,1
1,0,0,0,1 1,0,0,0,1 1,0,0,0,1 5,0,1,35,1 1,10,1,0,1 5,0,1,35,1 1,0,0,0,1 1,0,0,0,1 1,0,0,0,1
1,0,0,0,1 1,0,0,0,1 1,0,0,0,1 1,0,0,0,1 1,4,1,0,1 1,0,0,0,1 1,0,0,0,1 1,0,0,0,1 1,0,0,0,1
1,0,0,0,1 5,0,6,35,1 1,0,0,0,1 1,0,0,0,1 5,0,4,35,1 1,0,0,0,1 1,0,0,0,1 5,0,5,35,1 1,0,0,0,1
5,0,5,35,1 1,4,0,0,1 5,0,5,35,1 1,0,0,0,1 1,0,0,0,1 1,0,0,0,1 5,0,6,35,1 1,4,0,0,1 5,0,6,35,1
1,4,0,0,1 1,0,0,0,1 1,4,0,0,1 1,0,0,0,1 1,0,0,0,1 1,0,0,0,1 1,4,0,0,1 1,0,0,0,1 1,4,0,0,1
1,0,0,0,1 1,4,0,0,1 1,0,0,0,1 1,4,1,0,1 1,4,1,0,1 1,4,1,0,1 1,0,0,0,1 1,4,0,0,1 1,0,0,0,1
1,0,0,0,1 1,0,0,0,1 1,0,0,0,1 1,0,0,0,1 1,4,5,0,1 1,0,0,0,1 1,0,0,0,1 1,0,0,0,1 1,0,0,0,1
1,0,0,0,1 1,0,0,0,1 1,0,0,0,1 1,0,0,0,1 1,0,0,0,1 1,0,0,0,1 1,0,0,0,1 1,0,0,0,1 1,0,0,0,1