MODE 2
MODE2 4
MODE3 4
DONTINCLUDE 0/0/0
SIZE 9/9
BEACHBALL 0
MONEYBOX 0
TIMEBOMB 0
DROPING 0/0/0
LIMIT 0/45
COLOR LIMIT 6
BUNDLE ABILITY 0
COLOR PERCENT 100/0/100/100/100/100
STARS 100/4800/6900
COLLECT COUNT 20/25/0/0/0/0
COLLECT ITEMS 1/2/0/0/0/0
TOYS COUNT 1/0/0/0
TOYS ITEMS 1/0/0/0
1,0,0,0 1,0,0,0 1,0,0,0 1,0,0,0 1,4,0,0 1,0,0,0 1,0,0,0 1,0,0,0 1,0,0,0
1,0,0,0 1,0,0,0 1,0,0,0 1,4,0,0 5,0,3,35 1,4,0,0 1,0,0,0 1,0,0,0 1,0,0,0
1,0,0,0 1,0,0,0 1,4,0,0 5,0,6,35 1,4,1,0 5,0,5,35 1,4,0,0 1,0,0,0 1,0,0,0
1,0,0,0 1,4,0,0 5,0,4,35 1,4,1,0 5,0,5,35 1,4,1,0 5,0,5,35 1,4,0,0 1,0,0,0
1,4,0,0 5,0,3,35 1,4,1,0 5,0,3,35 1,10,1,0 5,0,6,35 1,4,1,0 5,0,1,35 1,4,0,0
1,0,0,0 1,4,0,0 5,0,4,35 1,4,1,0 5,0,6,35 1,4,1,0 5,0,6,35 1,4,0,0 1,0,0,0
1,0,0,0 1,0,0,0 1,4,0,0 5,0,1,35 1,4,1,0 5,0,1,35 1,4,0,0 1,0,0,0 1,0,0,0
1,0,0,0 1,0,0,0 1,0,0,0 1,4,0,0 5,0,1,35 1,4,0,0 1,0,0,0 1,0,0,0 1,0,0,0
1,0,0,0 1,0,0,0 1,0,0,0 1,0,0,0 1,4,4,0 1,0,0,0 1,0,0,0 1,0,0,0 1,0,0,0