MODE 3
MODE2 4
MODE3 4
DONTINCLUDE 9/0/0
SIZE 9/9
BEACHBALL 0
MONEYBOX 0
TIMEBOMB 0
DROPING 0/0/0
LIMIT 0/50
COLOR LIMIT 6
BUNDLE ABILITY 0
COLOR PERCENT 100/0/100/100/100/100
STARS 100/4800/6500
COLLECT COUNT 0/0/0/0/0/0
COLLECT ITEMS 1/2/0/0/0/0
TOYS COUNT 0/0/0/0
TOYS ITEMS 1/0/0/0
0,0,0 1,0,0 1,0,0 1,0,0 1,0,0 1,0,0 1,0,0 1,0,0 0,0,0
1,0,0 1,0,0 1,0,0 1,0,0 1,0,0 1,0,0 1,0,0 1,0,0 1,0,0
1,0,0 1,0,0 2,9,0 2,9,4 2,9,4 2,9,3 2,9,2 1,0,0 1,0,0
1,0,0 1,0,0 2,9,3 5,0,35 5,0,35 5,0,35 2,9,2 1,0,0 1,0,0
1,0,0 1,0,0 2,9,2 5,0,35 5,0,35 5,0,35 2,9,4 1,0,0 1,0,0
1,0,0 1,0,0 2,9,2 5,0,35 5,0,35 5,0,35 2,9,4 1,0,0 1,0,0
1,0,0 1,0,0 2,9,4 2,9,2 2,9,4 2,9,2 2,9,4 1,0,0 1,0,0
1,0,0 1,0,0 1,0,0 1,0,0 1,0,0 1,0,0 1,0,0 1,0,0 1,0,0
0,0,0 1,0,0 1,0,0 1,0,0 1,0,0 1,0,0 1,0,0 1,0,0 0,0,0