MODE 3
MODE2 4
MODE3 4
DONTINCLUDE 0/0/0
SIZE 9/9
BEACHBALL 0
MONEYBOX 0
TIMEBOMB 0
DROPING 0/0/0
LIMIT 0/52
COLOR LIMIT 6
BUNDLE ABILITY 1
COLOR PERCENT 100/0/100/100/100/100
STARS 5000/35000/65000
COLLECT COUNT 2/1/0/0/0/0
COLLECT ITEMS 1/2/0/0/0/0
TOYS COUNT 0/0/0/0
TOYS ITEMS 1/0/0/0
1,0,0,0,1 1,0,0,0,1 1,0,0,0,1 1,0,0,0,1 1,0,0,0,1 2,0,0,0,1 2,0,0,0,1 2,0,0,0,1 2,0,0,0,1
1,0,0,0,1 1,0,0,0,1 1,0,0,0,1 1,0,0,0,1 1,0,0,0,1 2,0,0,0,1 2,0,0,0,1 2,0,0,0,1 2,0,0,0,1
1,0,0,0,1 1,0,0,0,1 0,0,0,0,1 0,0,0,0,1 1,0,0,0,1 2,0,0,0,1 2,0,0,0,1 2,0,0,0,1 2,0,0,0,1
1,0,0,0,1 1,0,0,0,1 0,0,0,0,1 0,0,0,0,1 2,4,1,0,1 2,4,1,0,1 2,0,0,0,1 2,0,0,0,1 2,0,0,0,1
1,0,0,0,1 1,0,0,0,1 1,0,0,0,1 2,4,1,0,1 2,4,1,0,1 2,4,1,0,1 2,0,0,0,1 1,0,0,0,1 1,0,0,0,1
2,0,0,0,1 2,0,0,0,1 2,0,0,0,1 2,4,1,0,1 2,4,1,0,1 0,0,0,0,1 0,0,0,0,1 1,0,0,0,1 1,0,0,0,1
2,0,0,0,1 2,0,0,0,1 2,0,0,0,1 2,0,0,0,1 2,0,0,0,1 0,0,0,0,1 0,0,0,0,1 1,0,0,0,1 1,0,0,0,1
2,0,0,0,1 2,0,0,0,1 2,0,0,0,1 2,0,0,0,1 1,0,0,0,1 1,0,0,0,1 1,0,0,0,1 1,0,0,0,1 1,0,0,0,1
2,0,0,0,1 2,0,0,0,1 2,0,0,0,1 2,0,0,0,1 1,0,0,0,1 1,0,0,0,1 1,0,0,0,1 1,0,0,0,1 1,0,0,0,1