MODE 3
MODE2 4
MODE3 4
DONTINCLUDE 4/0/0
SIZE 9/9
BEACHBALL 0
MONEYBOX 0
TIMEBOMB 0
DROPING 0/0/0
LIMIT 0/60
COLOR LIMIT 6
BUNDLE ABILITY 0
COLOR PERCENT 100/0/100/100/100/100
STARS 100/4800/6200
COLLECT COUNT 0/0/30/30/0/0
COLLECT ITEMS 1/2/5/6/0/0
TOYS COUNT 0/0/0/0
TOYS ITEMS 1/0/0/0
5,0,6,50,2 2,4,0,0,1 1,0,0,0,1 1,0,0,0,1 0,0,0,0,1 1,0,0,0,1 1,0,0,0,1 2,4,0,0,1 5,0,6,50,2
5,0,1,50,2 2,4,0,0,1 1,0,0,0,1 1,0,0,0,1 0,0,0,0,1 1,0,0,0,1 1,0,0,0,1 2,4,0,0,1 5,0,1,50,2
5,0,4,50,2 2,4,0,0,1 1,0,0,0,1 1,0,0,0,1 0,0,0,0,1 1,0,0,0,1 1,0,0,0,1 2,4,0,0,1 5,0,4,50,2
5,0,5,50,2 2,4,0,0,1 1,0,0,0,1 1,0,0,0,1 1,0,0,0,1 1,0,0,0,1 1,0,0,0,1 2,4,0,0,1 5,0,5,50,2
5,0,3,50,2 2,4,0,0,1 1,0,0,0,1 1,0,0,0,1 1,0,0,0,1 1,0,0,0,1 1,0,0,0,1 2,4,0,0,1 5,0,3,50,2
5,0,6,50,2 2,4,0,0,1 1,0,0,0,1 1,0,0,0,1 1,0,0,0,1 1,0,0,0,1 1,0,0,0,1 2,4,0,0,1 5,0,6,50,2
5,0,1,50,2 2,4,0,0,1 1,0,0,0,1 1,0,0,0,1 0,0,0,0,1 1,0,0,0,1 1,0,0,0,1 2,4,0,0,1 5,0,1,50,2
5,0,4,50,2 2,4,0,0,1 1,0,0,0,1 1,0,0,0,1 0,0,0,0,1 1,0,0,0,1 1,0,0,0,1 2,4,0,0,1 5,0,4,50,2
5,0,5,50,2 2,4,0,0,1 1,0,0,0,1 1,0,0,0,1 0,0,0,0,1 1,0,0,0,1 1,0,0,0,1 2,4,0,0,1 5,0,5,50,2