MODE 3
MODE2 4
MODE3 4
TAG 0
DONTINCLUDE 4/0/0
SIZE 9/9
BEACHBALL 0
MONEYBOX 0
TIMEBOMB 0
DROPING 0/0/0
LIMIT 0/40
COLOR LIMIT 6
BUNDLE ABILITY 4
COLOR PERCENT 100/0/100/100/100/100
STARS 5000/30000/60000
COLLECT COUNT 0/0/30/30/0/0
COLLECT ITEMS 1/2/5/6/0/0
TOYS COUNT 0/0/0/0
TOYS ITEMS 1/0/0/0
0,0,0,0,1 1,0,0,0,1 1,0,0,0,1 1,0,0,0,1 1,0,0,0,1 1,0,0,0,1 1,0,0,0,1 1,0,0,0,1 0,0,0,0,1
1,0,0,0,1 1,0,0,0,1 1,0,0,0,1 1,0,0,0,1 1,0,0,0,1 1,0,0,0,1 1,0,0,0,1 1,0,0,0,1 1,0,0,0,1
1,0,0,0,1 1,0,0,0,1 1,0,0,0,1 1,0,0,0,1 1,0,0,0,1 1,0,0,0,1 1,0,0,0,1 1,0,0,0,1 1,0,0,0,1
1,0,0,0,1 1,0,0,0,1 1,0,0,0,1 1,0,0,0,1 1,0,0,0,1 1,0,0,0,1 1,0,0,0,1 1,0,0,0,1 1,0,0,0,1
1,0,0,0,1 1,0,0,0,1 1,0,0,0,1 1,0,0,0,1 1,0,0,0,1 1,0,0,0,1 1,0,0,0,1 1,0,0,0,1 1,0,0,0,1
2,4,0,0,1 2,4,0,0,1 2,4,0,0,1 2,4,0,0,1 0,0,0,0,1 2,4,0,0,1 2,4,0,0,1 2,4,0,0,1 2,4,0,0,1
2,4,0,0,1 5,0,1,35,2 5,0,3,35,2 2,4,0,0,1 0,0,0,0,1 2,4,0,0,1 5,0,1,35,2 5,0,3,35,2 2,4,0,0,1
2,4,0,0,1 5,0,4,35,2 5,0,5,35,2 2,4,0,0,1 0,0,0,0,1 2,4,0,0,1 5,0,4,35,2 5,0,5,35,2 2,4,0,0,1
2,4,0,0,1 2,4,0,0,1 2,4,0,0,1 2,4,0,0,1 0,0,0,0,1 2,4,0,0,1 2,4,0,0,1 2,4,0,0,1 2,4,0,0,1