MODE 3
MODE2 4
MODE3 4
DONTINCLUDE 0/0/0
SIZE 9/9
BEACHBALL 0
MONEYBOX 0
TIMEBOMB 0
DROPING 0/0/0
LIMIT 0/45
COLOR LIMIT 6
BUNDLE ABILITY 0
COLOR PERCENT 100/100/0/100/100/100
STARS 100/8900/15000
COLLECT COUNT 0/0/30/30/0/0
COLLECT ITEMS 1/2/5/4/0/0
TOYS COUNT 0/0/0/0
TOYS ITEMS 1/3/2/0
0,0,0,0,1 0,0,0,0,1 1,9,2,0,1 1,0,0,0,1 1,0,0,0,1 1,0,0,0,1 1,0,0,0,1 1,0,0,0,1 1,0,0,0,1
1,12,1,0,3 0,0,0,0,1 1,0,0,0,1 1,9,0,0,1 1,0,0,0,1 1,0,0,0,1 1,0,0,0,1 1,0,0,0,1 1,0,0,0,1
0,0,0,0,1 0,0,0,0,1 1,0,0,0,1 1,0,0,0,1 1,9,3,0,1 1,0,0,0,1 1,0,0,0,1 1,0,0,0,1 1,0,0,0,1
1,9,0,0,1 0,0,0,0,1 1,0,0,0,1 1,0,0,0,1 1,0,0,0,1 1,9,0,0,1 1,0,0,0,1 1,0,0,0,1 1,0,0,0,1
1,9,1,0,1 0,0,0,0,1 1,0,0,0,1 1,0,0,0,1 1,0,0,0,1 1,0,0,0,1 1,9,3,0,1 1,0,0,0,1 1,0,0,0,1
1,9,4,0,1 0,0,0,0,1 1,0,0,0,1 1,0,0,0,1 1,0,0,0,1 1,0,0,0,1 1,0,0,0,1 1,9,0,0,1 1,0,0,0,1
1,9,2,0,1 0,0,0,0,1 1,0,0,0,1 1,0,0,0,1 1,0,0,0,1 1,0,0,0,1 1,0,0,0,1 1,0,0,0,1 1,9,1,0,1
1,9,0,0,1 0,0,0,0,1 0,0,0,0,1 0,0,0,0,1 0,0,0,0,1 0,0,0,0,1 0,0,0,0,1 0,0,0,0,1 0,0,0,0,1
1,9,0,0,1 1,9,3,0,1 1,9,1,0,1 1,9,4,0,1 1,9,1,0,1 1,9,0,0,1 0,0,0,0,1 1,12,2,0,3 0,0,0,0,1