MODE 3
MODE2 1
MODE3 4
TAG 0
DONTINCLUDE 7/0/0
SIZE 7/7
BEACHBALL 0
MONEYBOX 0
TIMEBOMB 0
DROPING 0/0/0
LIMIT 0/42
COLOR LIMIT 6
BUNDLE ABILITY 9
COLOR PERCENT 89/0/93/94/94/92
STARS 3000/25000/50000
COLLECT COUNT 18/18/18/0/0/0
COLLECT ITEMS 4/5/6/0/0/0
TOYS COUNT 0/0/0/0
TOYS ITEMS 1/3/2/0
1,7,0,0,1 1,0,0,0,1 1,0,0,0,1 1,0,0,0,1 1,0,0,0,1 1,0,0,0,1 1,7,0,0,1
1,7,0,0,1 1,0,0,0,1 1,0,0,0,1 1,0,0,0,1 1,0,0,0,1 1,0,0,0,1 1,7,0,0,1
1,7,0,0,1 1,0,0,0,1 1,0,0,0,1 1,0,0,0,1 1,0,0,0,1 1,0,0,0,1 1,7,0,0,1
1,7,0,0,1 1,0,0,0,1 1,0,0,0,1 1,0,0,0,1 1,0,0,0,1 1,0,0,0,1 1,7,0,0,1
1,7,0,0,1 1,0,0,0,1 1,0,0,0,1 1,0,0,0,1 1,0,0,0,1 1,0,0,0,1 1,7,0,0,1
1,7,0,0,1 1,4,4,0,1 1,4,4,0,1 1,4,4,0,1 1,4,4,0,1 1,4,4,0,1 1,7,0,0,1
1,7,0,0,1 1,4,0,0,1 1,4,0,0,1 1,4,0,0,1 1,4,0,0,1 1,4,0,0,1 1,7,0,0,1