MODE 3
MODE2 4
MODE3 4
DONTINCLUDE 0/0/0
SIZE 9/9
BEACHBALL 37
MONEYBOX 0
TIMEBOMB 0
DROPING 0/0/0
LIMIT 0/35
COLOR LIMIT 4
BUNDLE ABILITY 4
COLOR PERCENT 100/0/0/100/100/100
STARS 1000/11000/20000
COLLECT COUNT 0/0/0/0/0/0
COLLECT ITEMS 0/0/3/4/0/0
TOYS COUNT 0/0/0/0
TOYS ITEMS 1/2/3/4
0,0,0,0,1 0,0,0,0,1 0,0,0,0,1 0,0,0,0,1 1,0,0,0,1 0,0,0,0,1 0,0,0,0,1 0,0,0,0,1 0,0,0,0,1
0,0,0,0,1 0,0,0,0,1 0,0,0,0,1 1,0,0,0,1 1,0,0,0,1 1,0,0,0,1 0,0,0,0,1 0,0,0,0,1 0,0,0,0,1
0,0,0,0,1 1,0,0,0,1 1,0,0,0,1 1,0,0,0,1 1,0,0,0,1 1,0,0,0,1 1,0,0,0,1 1,0,0,0,1 0,0,0,0,1
0,0,0,0,1 1,0,0,0,1 1,0,0,0,1 1,0,0,0,1 1,0,0,0,1 1,0,0,0,1 1,0,0,0,1 1,0,0,0,1 0,0,0,0,1
1,0,0,0,1 1,0,0,0,1 1,8,0,0,1 1,8,0,0,1 1,8,0,0,1 1,8,0,0,1 1,8,0,0,1 1,0,0,0,1 1,0,0,0,1
1,0,0,0,1 1,0,0,0,1 1,8,0,0,1 1,8,0,0,1 1,8,0,0,1 1,8,0,0,1 1,8,0,0,1 1,0,0,0,1 1,0,0,0,1
1,8,0,0,1 1,8,0,0,1 1,8,0,0,1 1,8,0,0,1 1,8,0,0,1 1,8,0,0,1 1,8,0,0,1 1,8,0,0,1 1,8,0,0,1
1,8,0,0,1 1,8,0,0,1 1,8,0,0,1 1,8,0,0,1 1,8,0,0,1 1,8,0,0,1 1,8,0,0,1 1,8,0,0,1 1,8,0,0,1
1,8,0,0,1 1,8,0,0,1 1,8,0,0,1 1,8,0,0,1 1,8,0,0,1 1,8,0,0,1 1,8,0,0,1 1,8,0,0,1 1,8,0,0,1