MODE 3
MODE2 4
MODE3 4
DONTINCLUDE 0/0/0
SIZE 9/9
BEACHBALL 0
MONEYBOX 12
TIMEBOMB 0
DROPING 0/0/0
LIMIT 0/34
COLOR LIMIT 6
BUNDLE ABILITY 0
COLOR PERCENT 100/0/100/100/100/100
STARS 100/10200/15000
COLLECT COUNT 0/0/18/0/0/0
COLLECT ITEMS 1/2/3/0/0/0
TOYS COUNT 0/0/0/0
TOYS ITEMS 1/3/2/0
0,0,0,0,1 0,0,0,0,1 1,0,0,0,1 1,0,0,0,1 1,0,0,0,1 1,0,0,0,1 1,0,0,0,1 0,0,0,0,1 0,0,0,0,1
0,0,0,0,1 1,0,0,0,1 1,0,0,0,1 1,6,0,0,1 1,0,0,0,1 1,6,0,0,1 1,0,0,0,1 1,0,0,0,1 0,0,0,0,1
1,0,0,0,1 1,0,0,0,1 1,0,0,0,1 1,0,0,0,1 1,0,0,0,1 1,0,0,0,1 1,0,0,0,1 1,0,0,0,1 1,0,0,0,1
1,0,0,0,1 1,6,0,0,1 1,0,0,0,1 1,0,0,0,1 1,6,0,0,1 1,0,0,0,1 1,0,0,0,1 1,6,0,0,1 1,0,0,0,1
1,0,0,0,1 1,12,1,0,1 1,0,0,0,1 1,6,0,0,1 1,12,3,0,1 1,6,0,0,1 1,0,0,0,1 1,12,1,0,1 1,0,0,0,1
1,0,0,0,1 1,6,0,0,1 1,0,0,0,1 1,0,0,0,1 1,6,0,0,1 1,0,0,0,1 1,0,0,0,1 1,6,0,0,1 1,0,0,0,1
1,0,0,0,1 1,0,0,0,1 1,0,0,0,1 1,0,0,0,1 1,0,0,0,1 1,0,0,0,1 1,0,0,0,1 1,0,0,0,1 1,0,0,0,1
0,0,0,0,1 1,0,0,0,1 1,0,0,0,1 1,6,0,0,1 1,0,0,0,1 1,6,0,0,1 1,0,0,0,1 1,0,0,0,1 0,0,0,0,1
0,0,0,0,1 0,0,0,0,1 1,0,0,0,1 1,0,0,0,1 1,0,0,0,1 1,0,0,0,1 1,0,0,0,1 0,0,0,0,1 0,0,0,0,1