MODE 3
MODE2 1
MODE3 4
DONTINCLUDE 0/0/0
SIZE 9/9
BEACHBALL 0
MONEYBOX 7
TIMEBOMB 0
DROPING 0/0/0
LIMIT 0/35
COLOR LIMIT 6
BUNDLE ABILITY 0
COLOR PERCENT 100/0/100/100/100/100
STARS 100/5600/7800
COLLECT COUNT 30/30/30/0/0/0
COLLECT ITEMS 1/5/6/0/0/0
TOYS COUNT 0/0/0/0
TOYS ITEMS 1/3/2/0
0,0,0,0 1,0,0,0 1,0,0,0 1,0,0,0 1,0,0,0 1,0,0,0 1,0,0,0 1,0,0,0 0,0,0,0
1,0,0,0 1,0,0,0 1,0,0,0 1,0,0,0 1,0,0,0 1,0,0,0 1,0,0,0 1,6,0,0 1,0,0,0
1,0,0,0 1,0,0,0 1,0,0,0 1,0,0,0 1,0,0,0 1,0,0,0 1,6,0,0 1,0,0,0 1,0,0,0
1,0,0,0 1,0,0,0 1,0,0,0 1,0,0,0 1,0,0,0 1,6,0,0 1,0,0,0 1,0,0,0 1,0,0,0
1,0,0,0 1,0,0,0 1,0,0,0 1,0,0,0 1,6,0,0 1,0,0,0 1,0,0,0 1,0,0,0 1,0,0,0
1,0,0,0 1,0,0,0 1,0,0,0 1,6,0,0 1,0,0,0 1,0,0,0 1,0,0,0 1,0,0,0 1,0,0,0
1,0,0,0 1,0,0,0 1,6,0,0 1,0,0,0 1,0,0,0 1,0,0,0 1,0,0,0 1,0,0,0 1,0,0,0
1,0,0,0 1,6,0,0 1,0,0,0 1,0,0,0 1,0,0,0 1,0,0,0 1,0,0,0 1,0,0,0 1,0,0,0
0,0,0,0 1,0,0,0 1,0,0,0 1,0,0,0 1,0,0,0 1,0,0,0 1,0,0,0 1,0,0,0 0,0,0,0