MODE 3
MODE2 1
MODE3 4
DONTINCLUDE 0/0/0
SIZE 9/9
BEACHBALL 0
MONEYBOX 10
TIMEBOMB 0
DROPING 0/0/0
LIMIT 0/40
COLOR LIMIT 6
BUNDLE ABILITY 0
COLOR PERCENT 100/100/98/100/0/98
STARS 5000/30000/60000
COLLECT COUNT 25/25/0/0/0/0
COLLECT ITEMS 3/6/0/0/0/0
TOYS COUNT 0/0/0/0
TOYS ITEMS 1/3/2/0
0,0,0,0,1 1,6,0,0,1 1,0,0,0,1 1,0,0,0,1 1,6,0,0,1 1,0,0,0,1 1,0,0,0,1 1,6,0,0,1 0,0,0,0,1
1,0,0,0,1 1,4,0,0,1 1,0,0,0,1 1,0,0,0,1 1,0,0,0,1 1,0,0,0,1 1,0,0,0,1 1,4,0,0,1 1,0,0,0,1
1,0,0,0,1 1,4,0,0,1 1,0,0,0,1 1,0,0,0,1 1,0,0,0,1 1,0,0,0,1 1,0,0,0,1 1,4,0,0,1 1,0,0,0,1
1,0,0,0,1 1,4,0,0,1 1,6,0,0,1 1,0,0,0,1 1,0,0,0,1 1,0,0,0,1 1,6,0,0,1 1,4,0,0,1 1,0,0,0,1
1,0,0,0,1 1,4,0,0,1 1,4,0,0,1 1,4,0,0,1 1,4,0,0,1 1,4,0,0,1 1,4,0,0,1 1,4,0,0,1 1,0,0,0,1
1,0,0,0,1 1,4,0,0,1 1,6,0,0,1 1,0,0,0,1 1,0,0,0,1 1,0,0,0,1 1,6,0,0,1 1,4,0,0,1 1,0,0,0,1
1,0,0,0,1 1,4,0,0,1 1,0,0,0,1 1,0,0,0,1 1,0,0,0,1 1,0,0,0,1 1,0,0,0,1 1,4,0,0,1 1,0,0,0,1
1,0,0,0,1 1,6,0,0,1 1,0,0,0,1 1,0,0,0,1 1,0,0,0,1 1,0,0,0,1 1,0,0,0,1 1,6,0,0,1 1,0,0,0,1
0,0,0,0,1 1,0,0,0,1 1,0,0,0,1 1,0,0,0,1 1,6,0,0,1 1,0,0,0,1 1,0,0,0,1 1,0,0,0,1 0,0,0,0,1