MODE 2
MODE2 4
MODE3 4
DONTINCLUDE 0/0/0
SIZE 8/8
BEACHBALL 0
MONEYBOX 0
TIMEBOMB 0
DROPING 0/0/0
LIMIT 0/22
COLOR LIMIT 6
BUNDLE ABILITY 0
COLOR PERCENT 100/0/0/100/100/0
STARS 100/5300/8600
COLLECT COUNT 45/45/0/0/0/0
COLLECT ITEMS 2/5/0/0/0/0
TOYS COUNT 1/1/1/1
TOYS ITEMS 1/2/3/4
0,0,0 0,0,0 0,0,0 0,0,0 0,0,0 0,0,0 0,0,0 1,10,4
0,0,0 0,0,0 0,0,0 0,0,0 0,0,0 0,0,0 1,0,0 1,6,0
0,0,0 0,0,0 0,0,0 0,0,0 0,0,0 1,10,3 1,0,0 1,0,0
0,0,0 0,0,0 0,0,0 0,0,0 1,0,0 1,6,0 1,0,0 1,6,0
0,0,0 0,0,0 0,0,0 1,10,2 1,0,0 1,0,0 1,0,0 1,0,0
0,0,0 0,0,0 1,0,0 1,6,0 1,0,0 1,6,0 1,0,0 1,6,0
0,0,0 1,10,1 1,0,0 1,0,0 1,0,0 1,0,0 1,0,0 1,0,0
1,0,0 1,6,0 1,0,0 1,6,0 1,0,0 1,6,0 1,0,0 1,6,0