MODE 3
MODE2 1
MODE3 4
DONTINCLUDE 0/0/0
SIZE 9/9
BEACHBALL 0
MONEYBOX 0
TIMEBOMB 0
DROPING 0/0/0
LIMIT 0/45
COLOR LIMIT 6
BUNDLE ABILITY 1
COLOR PERCENT 0/100/100/96/100/100
STARS 8000/45000/75000
COLLECT COUNT 45/0/0/0/0/0
COLLECT ITEMS 4/0/0/0/0/0
TOYS COUNT 0/0/0/0
TOYS ITEMS 1/2/3/0
1,0,0,0,1 1,0,0,0,1 1,0,0,0,1 1,0,0,0,1 1,4,0,0,1 1,0,0,0,1 1,0,0,0,1 1,0,0,0,1 1,0,0,0,1
1,0,0,0,1 1,0,0,0,1 1,0,0,0,1 1,4,0,0,1 1,11,0,0,1 1,4,0,0,1 1,0,0,0,1 1,0,0,0,1 1,0,0,0,1
1,0,0,0,1 1,0,0,0,1 1,4,0,0,1 1,11,0,0,1 1,11,0,0,1 1,11,0,0,1 1,4,0,0,1 1,0,0,0,1 1,0,0,0,1
1,0,0,0,1 1,4,0,0,1 1,11,0,0,1 1,11,0,0,1 1,11,0,0,1 1,11,0,0,1 1,11,0,0,1 1,4,0,0,1 1,0,0,0,1
1,4,0,0,1 1,11,0,0,1 1,11,0,0,1 1,11,0,0,1 1,11,0,0,1 1,11,0,0,1 1,11,0,0,1 1,11,0,0,1 1,4,0,0,1
1,11,0,0,1 1,11,0,0,1 1,11,0,0,1 1,11,0,0,1 1,4,0,0,1 1,11,0,0,1 1,11,0,0,1 1,11,0,0,1 1,11,0,0,1
1,11,0,0,1 1,11,0,0,1 1,11,0,0,1 1,4,0,0,1 1,11,0,0,1 1,4,0,0,1 1,11,0,0,1 1,11,0,0,1 1,11,0,0,1
1,11,0,0,1 1,11,0,0,1 1,4,0,0,1 1,11,0,0,1 1,11,0,0,1 1,11,0,0,1 1,4,0,0,1 1,11,0,0,1 1,11,0,0,1
1,11,0,0,1 1,4,0,0,1 1,11,0,0,1 1,11,0,0,1 1,11,0,0,1 1,11,0,0,1 1,11,0,0,1 1,4,0,0,1 1,11,0,0,1